Barcode	Cluster
AAACAGAGCGACTCCT-1	C
AAACCCGAACGAAATC-1	G
AAACCGGGTAGGTACC-1	D
AAACCGTTCGTCCAGG-1	E
AAACGAAGAACATACC-1	E
AAACGAGACGGTTGAT-1	B
AAACGTGTTCGCCCTA-1	C
AAACTAACGTGGCGAC-1	C
AAACTCGTGATATAAG-1	I
AAACTGCTGGCTCCAA-1	E
AAAGCTTGCCTACATA-1	I
AAAGGGATGTAGCAAG-1	H
AAAGGTAAGCTGTACC-1	C
AAAGTAGCATTGCTCA-1	D
AAAGTCACTGATGTAA-1	D
AAAGTGTGATTTATCT-1	B
AAAGTTGACTCCCGTA-1	B
AAATAACCATACGGGA-1	H
AAATAAGGTAGTGCCC-1	G
AAATACCTATAAGCAT-1	G
AAATAGCTTAGACTTT-1	G
AAATCGTGTACCACAA-1	E
AAATGATTCGATCAGC-1	I
AAATGGCATGTCTTGT-1	A
AAATGGTCAATGTGCC-1	E
AAATTAACGGGTAGCT-1	E
AAATTACACGACTCTG-1	H
AAATTACCTATCGATG-1	F
AAATTCCAGGTCCAAA-1	F
AAATTGATAGTCCTTT-1	A
AAATTGGTGAGAAGCA-1	C
AAATTTACCGAAATCC-1	C
AAATTTGCGGGTGTGG-1	A
AACAACTGGTAGTTGC-1	A
AACAATTACTCTACGC-1	E
AACACGACTGTACTGA-1	D
AACACGAGACGCGGCC-1	E
AACAGCTGTGTGGCAA-1	E
AACAGGAAATCGAATA-1	A
AACAGGATGGGCCGCG-1	D
AACATATCAACTGGTG-1	F
AACATCGATACGTCTA-1	C
AACCAAGACTTCTCTG-1	D
AACCAGTATCACTCTT-1	C
AACCCTACTGTCAATA-1	B
AACCCTGGTGGAACCA-1	D
AACCGAGCTTGGTCAT-1	H
AACCGCTAAGGGATGC-1	B
AACCGTTGTGTTTGCT-1	A
AACCTGTCACGGAATT-1	G
AACCTTTACGACGTCT-1	H
AACGATAGAAGGGCCG-1	D
AACGATATGTCAACTG-1	F
AACGCATGATCTGGGT-1	I
AACGCGGTCTCCAGCC-1	H
AACGGCCATCTCCGGT-1	A
AACGTACTGTGGGTAC-1	F
AACGTCAGACTAGTGG-1	D
AACGTGATGAAGGACA-1	C
AACGTGCGAAAGTCTC-1	B
AACTCAAGTTAATTGC-1	F
AACTCCTAATCCCATG-1	C
AACTCTCAATAGAGCG-1	B
AACTCTCAGTGTGCTC-1	A
AACTGAGGTCAGCGTC-1	C
AACTGATATTAGGCCT-1	A
AACTGGGTCCCGACGT-1	H
AACTGGGTTCGAGCCG-1	E
AACTTGCCCGTATGCA-1	D
AACTTTCTCGATCATG-1	I
AAGAAATCACCAGATT-1	I
AAGACTGCAAGCTACT-1	B
AAGAGATGAATCGGTA-1	E
AAGAGCTCTTTATCGG-1	B
AAGAGGATGTACGCGA-1	D
AAGAGGCATGGATCGC-1	B
AAGATGGCACCGGACC-1	D
AAGATTGGCGGAACGT-1	F
AAGCCGCTTTACCTTG-1	I
AAGCGGAGTGCGCGCA-1	C
AAGCGGCGTCATGGGT-1	C
AAGCGTCCCTCATCGA-1	A
AAGCTAGATCGAGTAA-1	G
AAGCTCGTGCCAAGTC-1	B
AAGGAGCGGTTGGTGC-1	A
AAGGATCGATCGCTTG-1	G
AAGGATGAGGGACCTC-1	F
AAGGCAGGCTGTCTCC-1	G
AAGGCGCGTAAAGCTT-1	D
AAGGCTGTGCTCATCG-1	A
AAGGGACAGATTCTGT-1	F
AAGGTATCCTAATATA-1	F
AAGGTGATAAACCAGC-1	B
AAGTAGAAGACCGGGT-1	D
AAGTAGTGACGCGAGG-1	D
AAGTCAATTGTCGTCA-1	B
AAGTCTAGTAGCTGCC-1	I
AAGTGACGACCGAATT-1	D
AAGTGCCTTGACTGTA-1	B
AAGTGCGTTAGAATCT-1	D
AAGTTCAGTCTGCGTA-1	C
AAGTTCGGCCAACAGG-1	A
AATAACAACGCTCGGC-1	D
AATAACACTAGAACAA-1	A
AATAAGTCCTCGAGAC-1	D
AATAGAACAGAGTGGC-1	F
AATAGAATCTGTTTCA-1	B
AATAGCAAGCCTCCTG-1	C
AATAGCTACCGCGTGC-1	C
AATATCGAGGGTTCTC-1	F
AATATTGGAGTATTGA-1	E
AATCCAAGGGCCTGAG-1	D
AATCGCCTCAGCGCCA-1	B
AATCGCGCAGAGGACT-1	G
AATCGGGACACTACGA-1	D
AATCTATGCCGGAGCC-1	I
AATCTGCGTTGGGACG-1	B
AATCTGGGTAGACCCT-1	C
AATGACAGCAATGTCT-1	A
AATGACGTAGGATGTC-1	B
AATGACTGTCAGCCGG-1	A
AATGATGATACGCTAT-1	G
AATGATGCGACTCCTG-1	F
AATGCAACCGGGTACC-1	H
AATGCACCAAGCAATG-1	H
AATGGTTCTCACAAGC-1	E
AATGTGCCCGAGGTGT-1	E
AATTAAAGGTCGGCGT-1	E
AATTAGCGCTGCAGCG-1	E
AATTCATAAGGGATCT-1	F
AATTCTAGAGTTAGGC-1	E
AATTGAACGCTCTGGT-1	B
AATTTGGGACATAGTA-1	C
AATTTGGTTCCAAAGA-1	A
ACAAATGGTAGTGTTT-1	B
ACAAATTCAGATCTGA-1	C
ACAACAGCATGAGCTA-1	B
ACAAGCAGTGCCTAGC-1	D
ACAAGGACAAGAGGTT-1	D
ACAAGGCCTACCAGCC-1	C
ACAAGGGCAGGCTCTG-1	B
ACAATCCATTTAAACC-1	D
ACAATGAATACGGAGA-1	D
ACAATGATTCTTCTAC-1	C
ACAATTTGAGCAGTGG-1	B
ACAATTTGGCCATATT-1	G
ACACAAAGACGGGTGG-1	A
ACACAAATATTCCTAG-1	C
ACACACCAGGACCAGT-1	B
ACACACTTTCTACACG-1	A
ACACCACATAATTAGC-1	G
ACACCCAGCATGCAGC-1	A
ACACCCGAGAAATCCG-1	D
ACACCTTAAGTAGGGC-1	A
ACACCTTACTACTTGC-1	G
ACACGAGACTCCTTCT-1	F
ACACGGCACTATGCAT-1	D
ACACGGGAACTTAGGG-1	F
ACACTGATCAAGGTGT-1	F
ACAGCATAGAGCCAGT-1	D
ACAGCGCACCCGCAGC-1	C
ACAGGTGGAGGTGAGG-1	A
ACAGTATACCGTGGGA-1	C
ACATAATAAGGCGGTG-1	H
ACATCCTGGTAACTGT-1	B
ACATCGATCGTTTACC-1	E
ACATCGGTCAGCCGCG-1	A
ACATCGTATGCAATGG-1	B
ACATCGTTAACCTAGT-1	A
ACATCTCAACGCGTAA-1	D
ACATGGCGCCAAAGTA-1	G
ACATTAGTTTATATCC-1	E
ACCAAACACCCAGCGA-1	C
ACCAACACCACACACT-1	I
ACCAACGCTTATTTAT-1	A
ACCAAGAACGCGTGTC-1	D
ACCACAACTCAGAACA-1	A
ACCACAAGTTTCTATC-1	F
ACCACCAATGTAACAA-1	G
ACCACCCTCTCTTCTA-1	I
ACCACGTGCAGCTATA-1	G
ACCAGCCCGGTCTTTG-1	E
ACCAGTGCCCGGTCAA-1	C
ACCAGTGCGGGAGACG-1	B
ACCATATCCGCAATAA-1	E
ACCATCGTATATGGTA-1	E
ACCCAACGCCCGTGGC-1	B
ACCCATCTTGAGGGTA-1	A
ACCCGGATGACGCATC-1	B
ACCCGGTTACACTTCC-1	E
ACCCTATGCCATATCG-1	A
ACCCTCCCTTGCTATT-1	B
ACCCTGGTAACGCCCT-1	C
ACCCTTCATCTGCGAA-1	A
ACCCTTGCCTGGGTCG-1	C
ACCCTTTAGTTCTCCA-1	D
ACCGAAAGGGCCCTGC-1	D
ACCGACTGAGTCCCAC-1	F
ACCGATGGTAGCATCG-1	B
ACCGCGGTGGAAGTCG-1	G
ACCGGGCCTTTGTTGA-1	B
ACCGGTCTGAGTACGG-1	E
ACCTAAGTACCTTTCA-1	A
ACCTAATCGACTTCCT-1	D
ACCTACAGTATGTGGT-1	G
ACCTCCGTTATTCACC-1	F
ACGAAATGGGCGGCAC-1	E
ACGAGATATTTGCTTA-1	C
ACGAGTACGGATGCCC-1	F
ACGATACATAGAACTA-1	H
ACGATCATACATAGAG-1	H
ACGATCATCTTGTAAA-1	G
ACGATGCATATGTTAT-1	A
ACGATGGATCCGATGC-1	A
ACGCAATCACTACAGC-1	I
ACGCATAAATGACATG-1	C
ACGCATTCGTGAGTAC-1	F
ACGCCAGATGATTTCT-1	H
ACGCCGCTAGACGACC-1	B
ACGCGAAGTCAGACGA-1	E
ACGCGCTACACAGGGT-1	D
ACGCGGGCCAAGGACA-1	F
ACGCTAGTGATACACT-1	F
ACGCTTAGTGTCTCTC-1	E
ACGGAGCGCAAATTAC-1	C
ACGGCACTTGCTTGGG-1	E
ACGGCCAACATGGACT-1	F
ACGGGAGTGTCGGCCC-1	D
ACGGGCGTATGCGACA-1	I
ACGTACAGATTTCTCT-1	D
ACGTAGATTGCTGATG-1	B
ACGTATTACTCCGATC-1	B
ACGTGCGCCTCGTGCA-1	A
ACGTTAATGTCGAAGA-1	B
ACGTTAGATTTGCCCG-1	A
ACGTTCGCAATCAATT-1	F
ACGTTTAGTTGTGATC-1	A
ACTAAGGACGCACACC-1	C
ACTAATACGTCAGGCG-1	C
ACTACCAGCTCTCTGG-1	D
ACTATATGCTGTGTTC-1	C
ACTATCCAGGGCATGG-1	G
ACTATTCGTCCGTGGT-1	C
ACTATTTCCGGGCCCA-1	D
ACTCAATAAAGGCACG-1	F
ACTCCCGAATTCGTTT-1	F
ACTCCCGTAGACTAGG-1	I
ACTCCCTAGAATAGTA-1	G
ACTCGCGATCTGACGC-1	G
ACTCGTAACCCGTCCT-1	E
ACTCGTCAGTAATCCC-1	B
ACTCTCTGACTTAGGT-1	B
ACTCTCTTATACACGA-1	C
ACTCTTCAGCTCCCGC-1	G
ACTCTTGTATAGTAAC-1	B
ACTGAATGGCGAAAGT-1	B
ACTGATTTAGTGATTC-1	D
ACTGCCGTCGTAACTC-1	A
ACTGCGGACACACCGT-1	G
ACTGGCGAACCTGCGT-1	C
ACTGTACGATACACAT-1	F
ACTGTAGCACTTTGGA-1	D
ACTGTCCAGGATTATA-1	E
ACTGTCTTCTTTAGAA-1	F
ACTTACCGGGCGCGCA-1	C
ACTTATACTTACCCGG-1	B
ACTTATTAGGATCGGT-1	E
ACTTATTTATGTGCCA-1	B
ACTTCGCCATACGCAC-1	F
ACTTCGCTAGCGAGTG-1	E
ACTTGACTCCCTCTTT-1	B
ACTTGGGACCCGGTGG-1	A
ACTTTACCCTCATGAA-1	F
ACTTTCCTATAGCTTC-1	F
AGAACCCAGCGTGACA-1	G
AGAACGTGGTACATTC-1	F
AGAAGAGCGCCGTTCC-1	F
AGAAGGTTGCCGAATT-1	E
AGAAGTGATTCGTGAT-1	D
AGAATGCGGGTTCGGA-1	C
AGAATTATGGATTCGA-1	F
AGACCCACCGCTGATC-1	E
AGACCCGCCCTCCTCG-1	F
AGACGACGATGCCGCT-1	A
AGACGGGCCGATTTAA-1	C
AGACTAGCCTTCCAGA-1	A
AGAGAACCGTCTAGGA-1	F
AGAGAAGGAGTACAAT-1	D
AGAGCGCTTGTAACGG-1	C
AGAGCGGGCTAATCAT-1	A
AGAGGGACAATTGTCC-1	C
AGAGTATAGTGTTACG-1	I
AGAGTTAGAGACCGAT-1	C
AGAGTTGCAGGCCTCC-1	C
AGATAACTTCAGGGCC-1	A
AGATACCAGCACTTCA-1	C
AGATACCGGTGTTCAC-1	A
AGATACTCAAGATCGA-1	B
AGATCGTGCATAAGAT-1	H
AGATCTCAGGTGTGAT-1	F
AGATGACTCGCCCACG-1	A
AGATGAGGGTTGCGAT-1	C
AGATGATGGAGTCTGG-1	F
AGATTATAGGACGTTT-1	E
AGCAACATATCTTATT-1	B
AGCACCAGTACTCACG-1	F
AGCACTTAAGGACGCC-1	D
AGCATCGTCGATAATT-1	A
AGCCACTCCCGTGCTT-1	F
AGCCCATACATGTAAG-1	D
AGCCCTAAGCGAAGTT-1	A
AGCCCTGTCGCACCGT-1	G
AGCCCTTCTAATCCGA-1	C
AGCGACAGGAACGGTC-1	A
AGCGACATCCCATTCA-1	A
AGCGACCAACGATATT-1	A
AGCGCGGGTGCCAATG-1	G
AGCGCTAGAGCGATGT-1	G
AGCGCTTATGGGCAAG-1	C
AGCGGTTGCCGCTCTG-1	C
AGCGTGGTATTCTACT-1	F
AGCTAGAAGCAGAAGT-1	I
AGCTATTTAATCCAAC-1	H
AGCTCGTTGATGGAAA-1	C
AGCTCTAGACGTTCCA-1	B
AGCTCTTCCCAGTGCA-1	H
AGCTCTTCGTAACCTT-1	G
AGCTCTTTACTCAGTT-1	E
AGCTGAAGTAAACCAA-1	H
AGCTGTAACCTCAATC-1	D
AGCTTGATCTTAACTT-1	D
AGGACAGTCGAATCCC-1	B
AGGACGACCCATTAGA-1	E
AGGACGCTCGATGTTG-1	H
AGGAGACATCCACAGT-1	I
AGGAGAGTCTGGCTAC-1	I
AGGATATAGGGATTTA-1	B
AGGATTGCTTACGACA-1	I
AGGCAGATGCGTAAAC-1	F
AGGCCACCCGTTATGA-1	A
AGGCCCATTGTACAGG-1	D
AGGCCCTAGAACGCCA-1	D
AGGCGTCTATGGACGG-1	C
AGGCTATGGTTAGCTT-1	D
AGGCTTCCCGAAGAAG-1	A
AGGGAAACGAGGTACT-1	C
AGGGACCGGCTGCGTT-1	F
AGGGACTCTACGCGAC-1	A
AGGGAGACATACTTCG-1	G
AGGGCAGCGGCGTGGT-1	A
AGGGCGTGATCGGCTA-1	D
AGGGCTGCAGTTACAG-1	B
AGGGTCAGTAACCCTA-1	C
AGGGTCGATGCGAACT-1	B
AGGGTGCTCTCGAGGG-1	B
AGGGTTCCCTTTGGTT-1	B
AGGGTTTAGTTCGGGA-1	F
AGGTACGATATTGCCA-1	A
AGGTAGGTACAAAGCT-1	D
AGGTATAATTGATAGT-1	G
AGGTATGCGGACATTA-1	G
AGGTCGCGGAGTTACT-1	F
AGGTTACACCATGCCG-1	G
AGGTTGAGGCACGCTT-1	H
AGGTTTCACACACCTT-1	B
AGTAACGTTCATCCTG-1	C
AGTAATGTCTTGCCGC-1	A
AGTACATCATTTATCA-1	F
AGTACCTTCGAGTGCT-1	C
AGTACGGGCACCTGGC-1	F
AGTACGTGGCCTGTCT-1	C
AGTAGCTAGACGCCGA-1	E
AGTAGGAAGGAAGTTG-1	C
AGTAGGTAACATACAT-1	D
AGTATAATACTAGGCA-1	D
AGTCAACACCACCATC-1	E
AGTCAAGATGACACTT-1	B
AGTCCATTGGCTGATG-1	B
AGTCCCGCCTTTAATT-1	H
AGTCCCTCGCAGAAAG-1	I
AGTCGACGGTCTCAAG-1	B
AGTCGGCCCAAACGAC-1	D
AGTCGGCTCAACTTTA-1	E
AGTCGGTTGCGTGAGA-1	G
AGTCGTGGGCATTACG-1	D
AGTCTAAAGTATACTC-1	G
AGTCTCACAAGACTAC-1	A
AGTCTTCTCCTCAAAT-1	H
AGTGAACAAACTTCTC-1	B
AGTGAAGATGGTGTCC-1	I
AGTGACCTACTTTACG-1	E
AGTGAGACTTCCAGTA-1	B
AGTGAGCCTCGCCGCC-1	F
AGTGAGGGTTTCTGAC-1	C
AGTGATATGAGTAGTT-1	E
AGTGATTCAAGCAGGA-1	B
AGTGCGTAGCTCGTAA-1	E
AGTGCTTGCACGAATA-1	B
AGTGGCGGCAATTTGA-1	G
AGTGTATTGCGCATTG-1	H
AGTTAAACACTTGCGA-1	E
AGTTAAGCGGTCCCGG-1	H
AGTTAAGTCAACCGCT-1	E
AGTTACTCTATCGTGG-1	H
AGTTCCTACAGAATTA-1	A
AGTTCCTATTTATGTT-1	E
AGTTTATGTAAAGACA-1	I
AGTTTCGCAGGTCGGA-1	A
AGTTTGGCCAGACCTA-1	A
ATAAACGGACCCGTAA-1	E
ATAAAGGCTCGGTCGT-1	E
ATAAAGGTCAAGTACG-1	C
ATAAATATTAGCAGCT-1	D
ATAACGCCGGAGGGTC-1	B
ATAACGGAGTCCAACG-1	F
ATAACGTTACCTCCAC-1	C
ATAAGCAAACACCGAG-1	C
ATAAGTACCCGATTGT-1	C
ATAAGTAGGATTCAGA-1	F
ATAAGTAGGGCGACTC-1	G
ATAAGTTACCGCGACG-1	E
ATAATAGCTGTTGAAT-1	E
ATAATAGTGTAGGGAC-1	E
ATACCACGGGCAACTT-1	D
ATACCAGGCTAATAGA-1	D
ATACCGTCATCCATAA-1	C
ATACGAAGGCTTTCCA-1	G
ATACGCCGGCGAAACC-1	B
ATACGGGTTTCGATTG-1	F
ATACGTCCACTCCTGT-1	B
ATACTAGCATGACCCT-1	A
ATAGACAACGGGACCT-1	F
ATAGACGAAGAGAAAG-1	A
ATAGAGTACTGGGACA-1	A
ATAGAGTTATCAACTT-1	F
ATAGGAATCTAAGCTT-1	C
ATAGGCGGCTATAGAA-1	A
ATAGGCTAGCTTCGCA-1	F
ATAGGGATATCCTTGA-1	H
ATAGGTTGGGCAGATG-1	F
ATAGTCTTTGACGTGC-1	D
ATAGTGAAGCGTTCTC-1	E
ATAGTTCCACCCACTC-1	B
ATATCAACCTACAGAG-1	G
ATATCGGTAGGGAGAT-1	G
ATATCGTGCCAGACCC-1	E
ATATCTCCCTCGTTAA-1	H
ATATCTTAGGGCCTTC-1	F
ATATGTCTCCCTAGCC-1	B
ATATGTGCACAAACCA-1	C
ATATTCAGTTAAACCT-1	A
ATATTCCCACAGGTCA-1	D
ATATTTAACCCTCAAG-1	F
ATCAAACACTGTTCCA-1	G
ATCAAACGAAGGTTTG-1	A
ATCAATCTGGGCTGCA-1	F
ATCACATTAGAATATC-1	H
ATCACGTGCTAATTAA-1	A
ATCACTTCATCCTCGC-1	H
ATCAGACGGCACGCCG-1	E
ATCAGGTCGCCATTGC-1	C
ATCAGTAGGCAGGGAT-1	F
ATCATCCAATATTTGT-1	E
ATCATGGACTACCGAC-1	G
ATCCAACGCAGTCATA-1	D
ATCCAATGGAGGGTCC-1	D
ATCCACGCTAAATGTT-1	C
ATCCACTTTCAGACTA-1	C
ATCCAGAGCAACAACC-1	E
ATCCAGGATTCGTGAA-1	E
ATCCTACCTAAGCTCT-1	E
ATCCTGAATCGCTGCG-1	D
ATCCTGCGTGGAATGG-1	E
ATCGACCCAATACAGA-1	E
ATCGACTCTTTCCGTT-1	F
ATCGCACGCCGGGAGA-1	A
ATCGCCAGTCAACATT-1	G
ATCGCTGCGTGCAGCA-1	I
ATCGGCAAGCAGTCCA-1	H
ATCGTTCACTTTCGCC-1	C
ATCTCCCTGCAATCTA-1	A
ATCTGCACCTCTGCGA-1	F
ATCTGGTTAAGACTGT-1	F
ATCTGTAATTGTACCC-1	A
ATCTTGACCTGCAACG-1	A
ATCTTGACTTGTCCAA-1	F
ATCTTTCGTATAACCA-1	I
ATGAAGCCAAGGAGCC-1	A
ATGACGCCGGCTCTAA-1	A
ATGACGCGTTCTATCC-1	A
ATGACTATGCGACATT-1	B
ATGAGGAGTGTTAATC-1	D
ATGAGGGCAGCGGCTA-1	G
ATGATCGGGAATAGAC-1	A
ATGATGCAATGGTACA-1	E
ATGCACTACCGCATTG-1	A
ATGCATGATCCAGGAT-1	H
ATGCCAATCGCTCTGC-1	C
ATGCCATTTGCGACCA-1	B
ATGCCGGTCTTGCATA-1	G
ATGCCGGTTGATGGGA-1	H
ATGCGACAATTGGTCC-1	C
ATGCGACAGTCCCATT-1	B
ATGCGAGTCCCACCAC-1	B
ATGGAACCTTTGCACA-1	G
ATGGAGCAGGCCGTGA-1	B
ATGGATCCGGCGTCCG-1	H
ATGGATTGACCAAACG-1	H
ATGGCGGAATAGTCGC-1	E
ATGGCTGGAAATGGCC-1	C
ATGGGAACGGAAGCGG-1	E
ATGGGCCTCGGCCTCT-1	B
ATGGTCGCGTGGTTTC-1	B
ATGGTTACGAAACATG-1	C
ATGTAAGGCTGCTCTT-1	F
ATGTGAAAGCCTAATG-1	E
ATGTGCATCCGACGCA-1	A
ATGTGGACATCTTGAT-1	G
ATTAAACATGCGGACC-1	E
ATTAATACTACGCGGG-1	H
ATTAATGAACCAGTCG-1	F
ATTAATTCGGTCACTC-1	A
ATTACAACTACCGGCC-1	C
ATTACGACTCCACAGT-1	C
ATTACGCGCTGGCAGG-1	D
ATTACTAGCCTCTTGC-1	D
ATTACTTACTGGGCAT-1	I
ATTAGATTCCTCAGCA-1	I
ATTAGATTGATAGCGG-1	A
ATTAGGCGATGCTTTC-1	B
ATTATACTTTGCTCGT-1	H
ATTATAGCTACTTTAC-1	F
ATTATCTCGACAGATC-1	D
ATTATGCCATAGGGAG-1	A
ATTATTATGTCCGTCA-1	D
ATTCAGGACCTATTTC-1	H
ATTCATATACTGTCCA-1	E
ATTCCTAAGACGTGGA-1	C
ATTCCTCCGCCAGTGC-1	D
ATTCGACGCCGGGCCT-1	D
ATTCGCAGAGGACACT-1	C
ATTCGTGCTATCTCTT-1	G
ATTCTCGTCTCTTTAG-1	D
ATTCTGAGTATGAACT-1	C
ATTCTTCGTACTTATG-1	C
ATTGAAGATCTTAGTG-1	F
ATTGACCGGCGATGAC-1	C
ATTGACGTAACTCGGT-1	D
ATTGATGAGTCCTAAC-1	B
ATTGCTGCTCCTCCAT-1	A
ATTGGGAATATCTTGG-1	D
ATTGGGAGTTCTGTAA-1	C
ATTGTACAACTCGGCT-1	F
ATTGTCGCAATACCTT-1	H
ATTGTGACTTCGCTGC-1	C
ATTTAACTCGTATTAC-1	D
ATTTACAGTTTACTGG-1	A
ATTTACTAAGTCCATT-1	F
ATTTCATTATTTCGCG-1	C
ATTTCCGGGTTCTGCG-1	A
ATTTGCGCGAGTAGCT-1	A
ATTTGTCTTGGGAGCT-1	B
ATTTGTTCCAGGGCTC-1	H
CAAACGAGTATCGCAG-1	E
CAAACGGTCGCACTTT-1	A
CAAACGTGGTCTTGCG-1	C
CAAACTACGATAGAGA-1	C
CAAACTATTGAGCTTC-1	A
CAAACTCGCGACGCCG-1	G
CAAAGATTATTGGGCC-1	D
CAAAGGTTAAATTCAG-1	C
CAAATCTCTCACAAGG-1	D
CAAATGTCCTTCCGTG-1	E
CAAATTGGATTATGCC-1	I
CAAATTGTCAGCAAGC-1	A
CAACACATCTCCTGCC-1	E
CAACCTGAACCTGCCA-1	I
CAACGACCCGTTTACA-1	A
CAACGGTTCTTGATAC-1	D
CAACTATATCGAATGC-1	H
CAACTCCAACGTTTAG-1	E
CAACTCCGTAACTTGC-1	C
CAACTCCTTGATCCCG-1	D
CAACTGAGGGTATGAC-1	C
CAAGAAACCCTAAACT-1	C
CAAGACTCAGAAGCGC-1	I
CAAGAGGGCGGAGTAC-1	G
CAAGATATTATAACGT-1	B
CAAGCAACGTCGGAGT-1	A
CAAGCACCAAATGCCT-1	A
CAAGGATCGCATGTTC-1	B
CAAGGTCCTATAGGCT-1	F
CAAGTGTGGTTGCAAA-1	B
CAATAAACCTTGGCCC-1	F
CAATACGAGAGTCTGA-1	G
CAATATGTAGATTTAC-1	C
CAATATTCTTGACCTA-1	A
CAATCCCTATACCAGC-1	C
CAATGAGGTTCGACTA-1	I
CAATGGAATCTACATA-1	C
CAATGGATCTCTACCA-1	G
CAATGTGCCAACCCTT-1	G
CAATTAAGGGTGATGA-1	F
CAATTTCGTATAAGGG-1	B
CACAAGAAAGATATTA-1	C
CACAATGAGCTGCTAT-1	E
CACACGCGCTGTCTTA-1	B
CACACGTTTCAATGGG-1	C
CACACTTGTATTGCGA-1	C
CACAGCACCCACGGCA-1	F
CACAGCTAGGGAGTGA-1	A
CACATATTAGCAGGAT-1	G
CACATCGTGCACGCGC-1	E
CACATGATTCAGCAAC-1	B
CACATTCTTTCGATGG-1	H
CACATTTCTTGTCAGA-1	G
CACCATCGGAGGAGAC-1	D
CACCATGATCGCAAAG-1	C
CACCCAAATCTTATGT-1	F
CACCCACACGTCACCC-1	D
CACCCACGAGGCAATT-1	H
CACCCGGTTTGTGACT-1	A
CACCGATACACCGAGC-1	C
CACCGCCAGAAGGTTT-1	H
CACCGCCGACCAGCGA-1	D
CACCGCGTCCACTCTA-1	C
CACCGGAGATATCTCC-1	C
CACCGTTAGGGATCAC-1	A
CACCGTTGCGCGATAT-1	D
CACCTAATCAGTTTAC-1	H
CACCTCGATGGTGGAC-1	H
CACCTTGCGAAACTCG-1	F
CACCTTGGCGCCTTTG-1	B
CACGAAAGTTAGTCCC-1	D
CACGACGTAATAGTAA-1	C
CACGCACAGCGCAGCT-1	F
CACGCAGCGAGGCTTT-1	A
CACGCGGAACTGTTGC-1	B
CACGGACGTGGATGGC-1	I
CACGGCGCGCCAAAGG-1	C
CACGTCGGCAACCTCT-1	A
CACGTCTATGATGTGG-1	C
CACGTTCGTGCTCTAG-1	B
CACTAAAGTTGCCTAT-1	E
CACTACTCAGTTCTGT-1	D
CACTCAAGAGCTATGG-1	E
CACTCAGCTCTTGAGG-1	A
CACTCCTATGTAAGAT-1	A
CACTCCTCTCGGTCGG-1	H
CACTCGAGCTGAACAA-1	G
CACTGTCCAAGTGAGA-1	D
CACTTAATCAGACGGA-1	F
CAGACACCGATCGCTG-1	F
CAGACCTGTAAGTGTT-1	F
CAGACGAACCTGATAC-1	E
CAGAGACGGTCACCCA-1	E
CAGAGCATGAGCTTGC-1	F
CAGAGGCGATGCATGA-1	A
CAGAGTGATTTAACGT-1	D
CAGATACTAACATAGT-1	A
CAGATCATTTAAAGTC-1	I
CAGCAGCCCGTTCCTT-1	B
CAGCCGGGCCCTCTAT-1	C
CAGCCTCCTGCAGAGG-1	F
CAGCCTCTCCTCAAGA-1	C
CAGCGATTCCCTTCAA-1	E
CAGCTCACTGAGACAT-1	F
CAGCTCGACAAGTTAA-1	F
CAGCTCGTGCTTGTGT-1	D
CAGCTGGCGTAACCGT-1	E
CAGCTTAGTAGGTAGC-1	D
CAGGAAGACTTTATAT-1	C
CAGGACAGCTGCCCTT-1	G
CAGGATATATCGTTGT-1	E
CAGGCCGTTTGGGTGT-1	F
CAGGCGCACGGTGGTC-1	D
CAGGCGCCATGCTAGG-1	G
CAGGTTTAGTACTACA-1	C
CAGTAACTATTTATTG-1	H
CAGTACATTCTCTAAA-1	I
CAGTAGCCCACGCGGT-1	F
CAGTCCAACGCCTTCT-1	C
CAGTCGAGGATGCAAT-1	F
CAGTCTGTATACTGGG-1	E
CAGTGAATAAATGACT-1	F
CAGTTCAAATTGACAC-1	F
CATAACGGACAGTCGT-1	B
CATACCCGTACCCAGT-1	D
CATACGGCGTCTGGGC-1	E
CATACTATGTAATTGT-1	E
CATACTTAGGCAATAC-1	F
CATAGCGTTGCCCACC-1	A
CATAGTACATTGAGAG-1	A
CATAGTAGCATAGTAG-1	D
CATAGTCCACAAGAAC-1	A
CATATACTACTGATAA-1	H
CATATAGGTACAGTCA-1	E
CATATGTCAGGCTACG-1	D
CATATTATTTGCCCTA-1	C
CATCAAACTGGCGCCC-1	C
CATCATCTACCCGGAC-1	A
CATCGCCCGCGGCCAA-1	D
CATCGGACGGGTTAAT-1	E
CATCTACCCGAGAACG-1	C
CATCTAGTGAAGGGAA-1	G
CATCTATCCCGTGTCT-1	H
CATCTTACACCACCTC-1	B
CATGAACCTCTTATCA-1	D
CATGACTTCGCTGAAT-1	G
CATGATGCACAATTCT-1	H
CATGATGGAAGTTAGC-1	B
CATGCACGTGTTACTG-1	E
CATGCATGGAGACCCT-1	D
CATGCCAACTCGCAAA-1	E
CATGCGACCAGTTTAA-1	F
CATGCGTTAGACAGAA-1	A
CATGCTGGCTCCAATT-1	D
CATGGAAATGGGACCA-1	C
CATGGCAGGAAGATCG-1	A
CATGGGTCGGGTGTGG-1	H
CATGGTAAGTAGCGTT-1	G
CATGGTCTAGATACCG-1	F
CATGTAGGAGCGCCAA-1	C
CATTACATAGATTGTG-1	I
CATTACGTCGGCCCGT-1	A
CATTATGCTTGTTGTG-1	A
CATTCACTGACAGCTA-1	E
CATTCCCATTCCGTCG-1	E
CATTGATGAACACGCC-1	C
CATTGCGGGTCAATTC-1	I
CATTTAGCGGACCATG-1	F
CATTTATCGTTCAAGA-1	D
CATTTGAGTGGTACGT-1	E
CCAAACAGAACCCTCG-1	A
CCAACGATGCACTGAT-1	A
CCAACGCTTGCCAGGG-1	C
CCAAGAAAGTGGGCGA-1	F
CCAAGACTTCTGCGAA-1	A
CCAAGCGTAACTCGTA-1	B
CCAAGGAACAGAGAGG-1	D
CCAATAGTGCCGTCGA-1	A
CCAATCGGTAGATCGA-1	H
CCAATGTCACAGCAAG-1	E
CCAATTACGGGTCGAG-1	H
CCAATTGAATGTTAAT-1	A
CCACAATGTACGTCTT-1	B
CCACACTGAGATATTA-1	E
CCACAGTACCCATCCT-1	B
CCACCAACTTTACTGT-1	A
CCACCCAAGGAAAGTG-1	B
CCACGAATTTAACCTC-1	G
CCACGAGAAGAGAATC-1	H
CCACGGAGCCATAAGA-1	D
CCACGGTGCCCGGTAG-1	G
CCACGTAAATTAGACT-1	E
CCACTATCCGGGTCAC-1	I
CCACTGGTGGCTGGTT-1	E
CCAGAAAGCAACTCAT-1	A
CCAGATAGTTGAGTGA-1	G
CCAGATGTAAATGGGT-1	I
CCAGCCTGGACCAATA-1	B
CCAGCGGGATCACCAG-1	E
CCAGGGACGTGGCCTC-1	A
CCAGTAGTCTGATCCA-1	F
CCAGTCTAGACGGCGC-1	F
CCATAAACAACCCGAC-1	A
CCATACCTTTACTTGT-1	F
CCATAGGTTGGCGTGG-1	A
CCATCGCAGTTAAACT-1	E
CCATCTCACCAGTGAA-1	B
CCATGCCTGTTTAGTA-1	E
CCATGCTCTGCAGGAA-1	D
CCATTAGCGATAATCC-1	A
CCATTCCCTGCCCACA-1	A
CCATTGTTTCCTCCAT-1	I
CCCAAACATGCTGCTC-1	B
CCCAACATACGTCGCG-1	A
CCCAACCACACTAACA-1	D
CCCAATGAGATTTGCA-1	E
CCCAATTTCACAACTT-1	A
CCCAGAGGAGGGCGTA-1	I
CCCAGTTAAGGCGCCG-1	B
CCCGACCATAGTCCGC-1	H
CCCGATAGCCTCGCCT-1	G
CCCGCAGCGCGAACTA-1	G
CCCGCAGGGCCCAAAG-1	A
CCCGCCATGCTCCCGT-1	D
CCCGTAAGTCTAGGCC-1	D
CCCGTAGCTGGGAAGA-1	A
CCCGTCAGCGTCTGAC-1	A
CCCTCATTCTGGAATT-1	D
CCCTGAAATGAGTTGA-1	A
CCCTGCGCTACGCATA-1	E
CCCTGGTATGGGCGGC-1	D
CCCTTTGACAGGTCTT-1	E
CCGAACCTTCCCGGCC-1	G
CCGAAGGGCGTACCGC-1	I
CCGACGGGCATGAGGT-1	E
CCGACGTAAACACAAC-1	C
CCGACTCGCATAGTCT-1	D
CCGAGAAGTCGCATAA-1	G
CCGAGCTGTGCTTGTC-1	C
CCGAGGGATGTTAGGC-1	D
CCGATCTCAACCTTAT-1	B
CCGATCTTAAGAGGCT-1	C
CCGCACAAAGACCAAC-1	B
CCGCACACGAACGTGT-1	G
CCGCACGTGACCTCGG-1	E
CCGCCGGTCAACACAC-1	D
CCGCCGTTGAGGATAA-1	G
CCGCCTGCGAATTGGT-1	C
CCGCGGAATGCGTCAC-1	F
CCGCGGGTACGAAGAA-1	D
CCGCTATCAGCACCAG-1	E
CCGCTGGTGCCATTCA-1	E
CCGCTTACCTCACTCT-1	A
CCGCTTGCTGACATGG-1	I
CCGGAATGGTTTCAGT-1	D
CCGGAGGTCTTATGGT-1	C
CCGGCACGACCGTTTC-1	F
CCGGCGCATATTGGAT-1	A
CCGGGACCCGCAGAGA-1	D
CCGGGCGGTCTCGTCA-1	B
CCGGGCTGCTCCATAC-1	B
CCGGGTTCGAGGTTAC-1	A
CCGGTAATGGCTAGTC-1	G
CCGGTTTGTAATTGTG-1	A
CCGTAAGTTGGTCCCA-1	B
CCGTATCTCGTCGTAG-1	D
CCGTATTAGCGCAGTT-1	C
CCGTGAGGCATTCATG-1	G
CCGTGCCCATGACGGC-1	D
CCGTGGAACGATCCAA-1	I
CCGTGTTAAATTCCAT-1	A
CCGTTACGTTAGAACA-1	H
CCGTTCCGAATCTCGG-1	E
CCTAAAGGCTGACGCT-1	C
CCTAAATTAACGGTTC-1	B
CCTAACTAAGGCTCTA-1	H
CCTACAAGTCCGGAAT-1	C
CCTACATTCACAGACG-1	A
CCTACTGCGGCGGCCA-1	I
CCTACTGCTTACACTT-1	A
CCTAGGCGTAGCGATC-1	B
CCTAGTTAGTCGCATG-1	A
CCTATACCGTCCTGTC-1	A
CCTATCTATATCGGAA-1	H
CCTATGAAGTGGTGCC-1	G
CCTATGGGTTACCGTC-1	F
CCTCACCTGAGGGAGC-1	F
CCTCACCTTAGCATCG-1	F
CCTCCCGACAATCCCT-1	D
CCTCCGACAATTCAAG-1	D
CCTCGAAGTGGACGGG-1	A
CCTCGCCAGCAAATTA-1	H
CCTCGCGCGATATAGG-1	H
CCTCGGACCGGGATAG-1	B
CCTCGTTACGCCTGTT-1	C
CCTCTAATCTGCCAAG-1	H
CCTCTATCGATTAGCA-1	E
CCTCTCTCCCATCTAG-1	A
CCTCTGGCCTAGACGG-1	C
CCTGAACGATATATTC-1	B
CCTGAATATTTACATA-1	H
CCTGACCACCGATGGT-1	E
CCTGCTATTTGAGAAG-1	A
CCTGGAAACGTTCTGC-1	G
CCTGGCTAGACCCGCC-1	A
CCTGTAAGACATGATA-1	A
CCTGTACTCACGCCCA-1	D
CCTGTCACCCGGGCTC-1	F
CCTGTCCCTCACGTTA-1	F
CCTGTCGCCCGTAAAT-1	E
CCTTCTTGATCCAGTG-1	H
CCTTTCAATGAAGAAA-1	F
CGAAACATAGATGGCA-1	C
CGAAACGCAATTCATG-1	A
CGAACATAGTCAGAAA-1	C
CGAACCCGCATGCGTC-1	E
CGAACGCCCAGTGCCG-1	A
CGAAGCTATAAATTCA-1	H
CGAAGTTGCTCTGTGT-1	A
CGACAATTTGATCTAA-1	B
CGACACCGCTTAAGGA-1	C
CGACACGCTCCGACAG-1	B
CGACAGTTCGCGTTAT-1	A
CGACATGCGATCTTCT-1	D
CGACTCAGGATGTTAT-1	F
CGACTCGGTACACGGT-1	C
CGACTTTGTATAGCCT-1	F
CGAGACCCTAGAGTGT-1	E
CGAGAGATGTGAACCT-1	F
CGAGATTTCGCTCGGG-1	G
CGAGCGTTGATCAGCC-1	E
CGAGCTGGGCTTTAGG-1	A
CGAGGAGCTTCCATAT-1	I
CGAGGATCGGGAACGA-1	I
CGAGGCTAAATATGGC-1	F
CGAGGGACTGCGGTCG-1	B
CGAGTACTAAAGAGGA-1	A
CGAGTGAAGGTACCAG-1	D
CGAGTTCTGTCCCACC-1	G
CGAGTTTATCGGACTG-1	B
CGATAATACTCAGGTT-1	G
CGATACCTCGCGGACA-1	E
CGATCATTAGAGGCAC-1	C
CGATCCGACCCAGTGC-1	E
CGATCTGTTGGAGGAC-1	D
CGATGGACCCTACGCC-1	G
CGCAAACACGAGTTAC-1	D
CGCAATTACTTTCGGT-1	D
CGCAATTAGGGTAATA-1	A
CGCAATTCTACAATAA-1	D
CGCACATGTCCACTAC-1	B
CGCACGTGCGCTATCA-1	B
CGCAGAAACATTTGCG-1	D
CGCAGATCTTCACCCG-1	I
CGCATCATGGCTTCAG-1	C
CGCATCCATCAGCCAG-1	I
CGCATGGTGCGATGCT-1	B
CGCATTAGCTAATAGG-1	H
CGCCATCCGATTATGA-1	F
CGCCCGCTTCCGTACA-1	H
CGCCGCCCATGCCTGT-1	B
CGCCGGTGTCGCAGTA-1	C
CGCCGTCTACCCATCG-1	G
CGCCTCCCTCCTCTAT-1	B
CGCCTGGCCTACGTAA-1	D
CGCCTTTAGCATGCTC-1	G
CGCGAGAGGGACTTGT-1	C
CGCGCATGTTTGATTG-1	E
CGCGCCCGACTTAATA-1	H
CGCGGCTCAACTTGAA-1	B
CGCGGGAATTAGGCAG-1	B
CGCGGTAAGTCTAGCT-1	I
CGCGGTCACAAACCAA-1	C
CGCGTACATTCTGGAA-1	C
CGCGTTCATGAAATAC-1	A
CGCTACGGGACATTTA-1	E
CGCTAGAGACCGCTGC-1	B
CGCTATTCTTAGGCTC-1	E
CGCTCGACATAATGAT-1	D
CGCTCTCCGTAGATTA-1	A
CGCTGGTGACTACCCT-1	B
CGCTGTGACGCCGCAC-1	A
CGCTGTGTGGATGTTG-1	D
CGCTTATTCCCGGTCG-1	D
CGCTTCCACTGAAATC-1	D
CGCTTTCATACCGGTG-1	D
CGCTTTCTTGCATTCG-1	B
CGGAAATTTCACATCC-1	D
CGGAACGTAAACATAG-1	E
CGGAGCATGGCGATCC-1	B
CGGAGCTTATAACACC-1	C
CGGAGTTTGAGAGACA-1	D
CGGCACCGTTAGCGCC-1	C
CGGCAGGGTCGGGTTG-1	B
CGGCCACGCACAAAGT-1	E
CGGCCCAACCTGTAGT-1	I
CGGCCCAGGTATATCC-1	F
CGGCTCTAAAGCTGCA-1	G
CGGCTCTTCGTCGAAC-1	C
CGGCTTTGTATGATAA-1	D
CGGGAATATAGTATAC-1	B
CGGGAATTTATGTAAA-1	E
CGGGATCAATGTAAGA-1	A
CGGGCAGCTAAACCGC-1	E
CGGGCCTTCTTTGTAA-1	E
CGGGTGTACCCATTTA-1	B
CGGGTTCGGCACGTAT-1	C
CGGTACTAGAATCAAA-1	B
CGGTAGAGGTGCAGGT-1	F
CGGTATAGGTATTAGC-1	C
CGGTCAAGTGGGAACC-1	F
CGGTCCATGAGACTCC-1	C
CGGTCTATCAACCCGT-1	H
CGGTGAAGACTAAAGT-1	E
CGGTGCAGATAGAACG-1	A
CGGTGCGCGTTGGTCC-1	A
CGGTGGGCTCCAGCCT-1	C
CGGTTATCCAACAGTG-1	F
CGGTTCAAGTAGGTGT-1	F
CGGTTGACCTGGCATA-1	D
CGGTTGGGTTCAAGTT-1	C
CGGTTTATGAAGGAAC-1	C
CGTACCTGATAGGCCT-1	H
CGTAGCGAATTGTCAG-1	A
CGTATTAAGAGATCTA-1	E
CGTATTGTTTCCTAAT-1	I
CGTCAAATGGTCGCAG-1	I
CGTCACGTCCATTGGT-1	E
CGTCAGTGCGCACAAG-1	E
CGTCGGATAGTGTTGA-1	B
CGTCTGGAAGGGCCCG-1	A
CGTCTTGAGTGTGACG-1	G
CGTGAAGTTAATTCAC-1	E
CGTGACATTGGGTCGT-1	H
CGTGCAGACTGGGACA-1	B
CGTGCATTGTCGACGC-1	A
CGTGCCCTCCCGAAGA-1	B
CGTGGCCGAATATCTA-1	B
CGTGTCCCATTCGCGA-1	A
CGTGTGTTAAACCCTG-1	F
CGTTAGCTCACAACTG-1	H
CGTTCTTCGCACACCT-1	C
CGTTGAGCGACCGTCG-1	B
CGTTGAGTAATTGCGT-1	C
CGTTGTAAGATTGATT-1	I
CGTTGTTTCAATTCCC-1	A
CGTTTAAGCGGAGCAC-1	D
CGTTTACAAGGCAGCT-1	C
CGTTTCACTTCGGGCG-1	H
CGTTTCGCTCATTACA-1	E
CGTTTGTGTAGAGGGT-1	A
CTAAAGAATGCCTACT-1	A
CTAAAGGGAAATAGGA-1	E
CTAAATCCTATTCCGG-1	F
CTAACCGCGCGCCCGT-1	A
CTAACGAAACTTGCTG-1	F
CTAACTGGTCCGGTTC-1	A
CTAAGGGAATGATTGG-1	B
CTAAGTACAGGGCTAC-1	C
CTAATTATGAAGCGTA-1	C
CTAATTCGCACGCGCT-1	D
CTAATTCTCAGATATT-1	F
CTACAAGAAATAACCC-1	A
CTACCCTAAGGTCATA-1	B
CTACGAACTAGGTCGA-1	D
CTACGACTAGCTATAA-1	D
CTACGCACGGAGTACC-1	E
CTACGCCATTTCCGAT-1	A
CTACTATCATAGGTTT-1	E
CTACTATCTTTCAGAG-1	F
CTACTCTAGGCCCGGC-1	D
CTACTGCCACCTGACC-1	H
CTAGACATATATGTAG-1	C
CTAGACTGCATTTCGT-1	C
CTAGATGTGAGTGTAA-1	F
CTAGATTTACGACGGC-1	B
CTAGCATAGTATAATG-1	B
CTAGCCGATGTTATGA-1	I
CTAGGTCTGAAGGAAT-1	G
CTAGTATTCGGAATTA-1	C
CTAGTCACGTCTTAAG-1	B
CTAGTGAAGGACAGGA-1	A
CTAGTTGGGCCCGGTA-1	H
CTATAAGAGCCAATCG-1	F
CTATCGGGTCTCAACA-1	B
CTATGTCACTAGCCCA-1	F
CTATGTCTATTGAAAC-1	D
CTATTGTGTTTGGTCA-1	H
CTATTTGGTTACGGAT-1	B
CTCAAGACATTAGCGC-1	C
CTCACACGCAAGCCTA-1	C
CTCACCGATCCAAACT-1	C
CTCACTTGGCTGGTAA-1	D
CTCAGTCACGACAAAT-1	G
CTCATCACTTAGTGAT-1	I
CTCATGGCTCACAATC-1	A
CTCATGGTAATTTGCG-1	D
CTCATTAACGTTGCCC-1	I
CTCATTTGATGGGCGG-1	H
CTCCGCCCACATGAGG-1	A
CTCCGGCCTAATATGC-1	A
CTCCTTTACGCAAGTC-1	I
CTCGAATGGAACGTAT-1	C
CTCGAGGTCGAACAGT-1	F
CTCGATATTTGCGAGC-1	I
CTCGCACCTATATAGT-1	H
CTCGGGATAACACCTA-1	I
CTCGGTACCACTGCTC-1	B
CTCGGTCCGTAGCCTG-1	A
CTCGTTTCTAATGTTT-1	I
CTCTAATGCATTGATC-1	I
CTCTATTTGGCTGCAG-1	G
CTCTCACAATCGATGA-1	B
CTCTGCGAAGCAAGCA-1	D
CTCTGGACGCCTGGTG-1	F
CTCTGTTTGAGGATTC-1	A
CTCTTCTATTGACTGG-1	B
CTGAAAGAGATCCGAC-1	H
CTGAATCCGAGACCTC-1	E
CTGAATTTATTGCCAG-1	I
CTGACTGCGCAGCTCG-1	F
CTGAGCGAGACTTATT-1	G
CTGCACCTAGTCCACA-1	I
CTGCACCTGGAACCGC-1	D
CTGCCAAGGTTGGAAG-1	H
CTGCCATGCATCACAT-1	E
CTGCCTAGCCACCAAG-1	A
CTGCCTCATATGCAAC-1	E
CTGCGGTAGTCACGTG-1	C
CTGCGTTACGATATAA-1	H
CTGCTGAGGCCACGAA-1	A
CTGCTTTATGTCCGCG-1	I
CTGGAAATGGATGCTT-1	F
CTGGATTTACACTTGA-1	E
CTGGCATCCGAATGAG-1	D
CTGGCGACATAAGTCC-1	H
CTGGCGCACAGGTCTG-1	B
CTGGCTGATTCATCCT-1	B
CTGGGATAAATAATGG-1	B
CTGGGATACGCTACCC-1	G
CTGGGCCTGCTATATC-1	D
CTGGGCTATCCTTTGG-1	C
CTGGGTAGGCAGTTAA-1	B
CTGGTAACACATAGAA-1	B
CTGGTAACGAGCTCTT-1	F
CTGGTCCTAACTTGGC-1	D
CTGGTTCGCGAGCTAC-1	G
CTGGTTTCGAGCAAGA-1	B
CTGTACTTCTTAGCAT-1	E
CTGTAGCCATCTCACT-1	A
CTGTCAAATGGCTCGG-1	F
CTGTCACGCCAGGCGC-1	C
CTGTGCAGGGTAGGTC-1	B
CTGTTACCCAATCTAG-1	E
CTGTTCACTGCCTGTG-1	A
CTGTTCATCTCACGGG-1	D
CTTAACTTCGAAGTAC-1	D
CTTACACGGTATTCCA-1	A
CTTACACTGGGAAATA-1	D
CTTAGCCTTCCACATG-1	H
CTTAGGTCCCAATCGT-1	I
CTTAGTAGGCCTACAG-1	F
CTTCATAGCTCAAGAA-1	D
CTTCATTGTCAGTGGA-1	E
CTTCCGCTCCGTGAAG-1	A
CTTCCTGCATATTTAC-1	C
CTTCGTAGATAGGTGA-1	E
CTTCTATGTTGAAGTA-1	D
CTTCTATTAATGCTAG-1	F
CTTCTTACGTCGTATA-1	A
CTTGACCCGAAAGATA-1	D
CTTGAGTTAGGGTAAT-1	B
CTTGCAACCGCCTCCT-1	D
CTTGCCCAGGCTCTAC-1	E
CTTGTACTTGTTGACT-1	A
CTTGTGCTCACCGATT-1	G
CTTGTTGCTGAGTCAA-1	B
CTTTAACTTTCAAAGG-1	H
CTTTAGGAACACTGTT-1	B
CTTTAGTGCTATTATT-1	E
CTTTGGCAGACAGAGT-1	C
CTTTGGCTTTAGTAAA-1	A
GAAACAGATGACCACC-1	B
GAAACAGCCATGCAGT-1	A
GAAACCATGGTGCGCT-1	I
GAAACCGAATTACCTT-1	E
GAAACTCTAATGAAGG-1	A
GAAAGAACAGCGTTAT-1	G
GAAAGTGACTAACTGC-1	D
GAAATACCTGCTGGCT-1	C
GAAATATCACCATCAG-1	E
GAAATATGCTTGAATG-1	C
GAAATCGCGCGCAACT-1	A
GAAATGGCGGTGTTAG-1	F
GAAATTAGCACGGATA-1	H
GAAATTCACATCGCTG-1	D
GAAATTGTCTCTATAA-1	E
GAACACACATCAACCA-1	A
GAACATTAGTATGTTA-1	C
GAACGACCGAATGATA-1	A
GAACGATAAGTTAAAG-1	I
GAACGTCTCATGGTCG-1	B
GAACTTAGCGCCCGGT-1	C
GAACTTGTGCACGGGA-1	C
GAAGCGTGAGGAATTT-1	F
GAAGCTTGCTGACCGC-1	D
GAAGGCTACCATTGTT-1	I
GAAGTCAGTTGCACTA-1	E
GAAGTCTCCCTAGCGA-1	B
GAAGTGATTTATCGTG-1	E
GAAGTGCTGGATAGCT-1	A
GAAGTTTCCACTCAAT-1	E
GAATAGACGCGACCCA-1	B
GAATAGCATTTAGGGT-1	G
GAATAGCCCTGCGGTC-1	C
GAATAGTGCTCGATTA-1	E
GAATATTCGGAGTCCC-1	C
GAATCGACATGGTCAC-1	A
GAATCTGAACATTCTC-1	E
GAATGAAGGTCTTCAG-1	C
GAATGTATGGCAGGTC-1	H
GAATGTGGTCCGGATT-1	B
GAATGTTGGGTAATCT-1	H
GAATTATAGTGAAAGG-1	B
GAATTCACCCGGGTGT-1	E
GAATTTCTCGCTGCAG-1	D
GACAAACATATGCAGG-1	B
GACAACGACCATTGAA-1	F
GACAACGCAGCTTACG-1	A
GACACAAGGGAAGAAA-1	F
GACACTGAGTTCAGTG-1	E
GACAGCCAGACCTGAC-1	B
GACAGGCACACACTAT-1	E
GACATCGATTTATAAC-1	F
GACCAGAGCCCTGTAG-1	A
GACCCGTCGCCGGCTA-1	D
GACCGACGTGAAAGCA-1	G
GACCGTCAGGTCGTGA-1	C
GACCGTGCTGACGGTG-1	E
GACGCTTGCTTCTAAA-1	A
GACGGTCAATAGAAGC-1	F
GACGGTCCTAGGGTGT-1	G
GACGTGTAGGGATTAT-1	D
GACGTTCGTAAATACA-1	I
GACTAACACAGCACCT-1	C
GACTAAGATCATGCAC-1	A
GACTAAGTAGGCTCAC-1	A
GACTACAATTGCTCGT-1	C
GACTCACCCACGTGAG-1	G
GACTCCCAGAATAAGG-1	I
GACTCGCGGGAATGAC-1	F
GACTCGGTCGGCGGAT-1	C
GACTGATTGGTCACAA-1	C
GACTGCACCAGCCCAG-1	B
GACTGGGCGCCGCAAC-1	C
GAGACCCTGCAACGCC-1	C
GAGACTGATGGGTAGA-1	F
GAGAGGGCGCGAGGTT-1	A
GAGAGGTGCATTCTGG-1	D
GAGATCTGCTTGGCAT-1	A
GAGATCTGTCACTCCG-1	B
GAGATCTTCCATGACA-1	B
GAGATGACAATCCTTA-1	I
GAGCACGGCGCCTCTT-1	G
GAGCCGAGCGTTTATT-1	C
GAGCGAGGGAGTACCG-1	A
GAGCTAAGGGCATATC-1	B
GAGCTGTCGTCTCGGA-1	H
GAGGAATGGAGAGGTT-1	D
GAGGATAAACAGTGCT-1	G
GAGGCATTTGCAGCAG-1	C
GAGGCTATCAAAGTCG-1	D
GAGGGCCATAATATTA-1	I
GAGGGCGCAGCTCTGC-1	F
GAGGTACATCCATCTT-1	A
GAGTACGGGTATACAA-1	D
GAGTATGCCCGCCTTG-1	F
GAGTCAGACCAGAATC-1	A
GAGTCCGCTTACCGGA-1	E
GAGTGCACGGACAACA-1	I
GAGTGTGCGGTACCCA-1	B
GATAAATCGGTGGATG-1	D
GATAACTCGCACTGTG-1	B
GATACCGTGTCGGAGT-1	G
GATACGATGGGAGTCA-1	E
GATAGGATTAATTACA-1	G
GATAGGTAACGTTGAC-1	E
GATAGGTGTCCCGGGC-1	G
GATATCTCATGCAATA-1	D
GATATGAGACACTAAC-1	B
GATATGCGGTAGCCAA-1	H
GATATTGAGATTGGCG-1	B
GATATTTCCTACATGG-1	H
GATCATTCCAAACATT-1	F
GATCCCTTTATACTGC-1	F
GATCCGAATATAAGTG-1	G
GATCCGGGAATTAACA-1	B
GATCCTAAATCGGGAC-1	F
GATCCTCGACACTGGC-1	A
GATCCTCTTGCGCTTA-1	C
GATCGACACTATCTGA-1	A
GATCGCGGGCTCTCCA-1	E
GATCGGTGGCCATAAC-1	F
GATCGTGACTGATATC-1	B
GATCTTGGAGGGCATA-1	B
GATCTTTGCAGGGTAT-1	A
GATCTTTGCTCAAAGA-1	C
GATGACAAGTAGGGCA-1	D
GATGACGATGATCGCG-1	C
GATGCGTCCTGCATTC-1	E
GATGCTACAAGCGCCT-1	A
GATGCTGTATTTCATC-1	B
GATGGTGAAATAACCC-1	C
GATGGTGCCCTAGGCA-1	C
GATGTCGGTCAACTGC-1	A
GATGTGTTGTCACAAG-1	D
GATGTTCAATCCACGA-1	E
GATTACTGAATTTGGG-1	A
GATTCCCTTGTCGCAG-1	H
GATTCCGCGTTTCCGT-1	H
GATTCGACGGTTCACG-1	B
GATTTAGTGCGTACTG-1	C
GCAAACCCTACATTAT-1	B
GCAAATATTACGCTTT-1	A
GCAACAGCAGTATGCG-1	F
GCAACCACCAGACCGG-1	H
GCAACCACGGCCGCGT-1	D
GCAACGGCTAGTTATG-1	G
GCAAGAATTCCTTGGC-1	A
GCAAGATGTGTTCGCG-1	C
GCAAGTGCACAGAGAA-1	D
GCAATTAGTCGCACCG-1	I
GCACAAACGAGGCGTG-1	G
GCACAAGTGTCGGAAG-1	D
GCACGCCTACTTAGAT-1	A
GCAGAAACGTAATCCA-1	C
GCAGACCCAGCACGTA-1	B
GCAGATTAGGGATATC-1	E
GCAGCACACAGCCCAG-1	A
GCAGCCTATATCACAT-1	F
GCAGCTATGGACAGGT-1	C
GCAGGACTATAGAATA-1	A
GCAGGTAGAGTATGGT-1	H
GCATAAATTGAACGCC-1	C
GCATAGAGCACTCAGG-1	E
GCATCCCTAACTTTGA-1	D
GCATGAGGGACGCGGC-1	B
GCATTCAAGGCAACGC-1	F
GCATTGTAATTCATAT-1	E
GCATTTCCAAGGCTCC-1	F
GCCAACCATTTCCGGA-1	I
GCCAATAGGGCATCTC-1	G
GCCACAATTTAAGGAC-1	A
GCCAGGAGTAACCGAT-1	F
GCCAGGCGTTCGCATG-1	C
GCCATATTGCACACAG-1	F
GCCATCGAGCTGCGTG-1	A
GCCATCGATGCTGCAT-1	F
GCCCAGATGCTGGAGA-1	G
GCCCAGTTGGTATGCC-1	D
GCCCGACTTCTTCCCG-1	D
GCCCGCGCGTAAACGG-1	A
GCCCGCGCGTTTGACA-1	D
GCCCGTAATACCTTCT-1	F
GCCGAAATTCCTACGT-1	F
GCCGATTGGCCAAGCT-1	E
GCCGCACTCCGTTTCA-1	G
GCCGCTTGTGAGAAAC-1	A
GCCGGGTTAGGGTCGC-1	E
GCCGTGGAAGAAATGT-1	G
GCCTAGCGATCTGACC-1	D
GCCTATAGTGTCAGGG-1	B
GCCTATGCTGGGCCTT-1	C
GCCTATTCCGATATAG-1	D
GCCTCATCTGGAAATA-1	B
GCCTGCTACACTGAGA-1	C
GCCTTCAGCCCTACCG-1	D
GCGAAACTTAACTGGA-1	B
GCGAAGCCATACCCGT-1	F
GCGACATGTAAACATC-1	F
GCGACCCAACCATCTG-1	D
GCGACGATAGTTGTAC-1	E
GCGAGAGGCCATGTAA-1	I
GCGAGAGTTGCGTCCA-1	F
GCGAGCGCATGCTCCC-1	G
GCGAGGCCCGAGCAGA-1	E
GCGAGTTCTGCAAAGA-1	E
GCGATTCTGGAAGCAG-1	A
GCGATTGTTAACGTTA-1	B
GCGCAAGAGCGCGCTG-1	B
GCGCATCCAGTCAGCA-1	F
GCGCCGTTCCACGATA-1	E
GCGCTAATTGAATAGA-1	B
GCGCTATGCCGAGGCA-1	E
GCGCTGATCCAGACTC-1	H
GCGCTGCTTTGCATTT-1	F
GCGGACCGCGTTGTGG-1	F
GCGGAGAAACTTCGCA-1	A
GCGGAGAGGGAGAACG-1	B
GCGGCTCTGACGTACC-1	A
GCGGGAACCAGGCCCT-1	D
GCGGGCATTACGATGC-1	I
GCGGGCGAGCCTTACC-1	A
GCGGTCCCGGTGAAGG-1	C
GCGGTCCCTAGACGCA-1	E
GCGGTGAACTGCGCTC-1	H
GCGGTTCCCTATCATG-1	E
GCGTAAATGGCCATAA-1	F
GCGTCGAAATGTCGGT-1	A
GCGTCTCTGCATTGGG-1	A
GCGTGGTACTGGGTTA-1	B
GCGTTCGGAGACCGGG-1	H
GCTAAGTAGTTTCTCT-1	B
GCTAATACCGAATGCC-1	A
GCTACGACTTATTGGG-1	B
GCTAGACCGTCTACTG-1	B
GCTAGCACCTGGGCCA-1	G
GCTAGCAGGGAGTGGG-1	C
GCTAGCTTGAATAGCT-1	F
GCTAGTAGAGCTTGTA-1	B
GCTAGTTTCATTGAGG-1	E
GCTCAATCCGTTTATT-1	A
GCTCATTACTGCATGT-1	C
GCTCCCAGTCGGTCCA-1	G
GCTCCGCTCGCTTCAG-1	G
GCTCCTGACATACTGG-1	A
GCTCGCTCATGTCCAA-1	B
GCTCGGAATTTAAAGC-1	F
GCTCTAAACCCTGACG-1	A
GCTCTATGTTACGTGC-1	D
GCTCTCGGGTACCGAA-1	H
GCTGAACTCTCCAGGG-1	G
GCTGAGGCGTGAGTAT-1	E
GCTGCACGGTTTCTTA-1	B
GCTGCTCTCCGGACAC-1	F
GCTGGACCCAAAGTGG-1	C
GCTGGCATATTCACCT-1	D
GCTGGTGACTCGTAGT-1	C
GCTGTATTACTGGCCC-1	A
GCTGTTGCTACCGAAC-1	B
GCTTAATGTAACTAAC-1	B
GCTTACGTAGTTAGTA-1	F
GCTTAGGGAAGCGGTA-1	C
GCTTATGAAGCAGGAA-1	B
GCTTCAGTGGGATTAC-1	C
GCTTCCGTCCCTAGAC-1	B
GCTTGATGATAATCAG-1	D
GCTTGCAGCACAATTG-1	C
GCTTGGATCGATTAGG-1	F
GCTTTCAGAGGAGGTG-1	B
GGAAACCTTGTTGAAT-1	I
GGAAAGTGCCCATGCC-1	H
GGAACCGTGTAAATTG-1	E
GGAAGATAAGACTGTA-1	C
GGAAGCTCGCTTACAG-1	C
GGAATGCGCTAGCGTG-1	B
GGACCTACGGTAACGT-1	C
GGACCTCTAGGCCGCC-1	E
GGACGGCTTGCGCAAC-1	C
GGACGTCCATAGTTGG-1	C
GGAGAAGTCATTGGCA-1	D
GGAGACCAATGTGCTT-1	C
GGAGACGACACCTTTG-1	E
GGAGCACCAAGAACTA-1	F
GGAGGATTGAAAGGAG-1	D
GGAGGCCGAAGTCGTC-1	G
GGAGGGCTTGGTTGGC-1	B
GGAGTGCCGCCCTGGA-1	A
GGATCATCCCGTACGC-1	H
GGATCCGGAATATACT-1	B
GGATGAAGATCGCTGA-1	B
GGATGACGCGAGTTTA-1	E
GGATGTCCTTACCGCA-1	B
GGATTAAGCTAAGGTC-1	C
GGATTCCGCTATACCC-1	H
GGATTTCACTTCTATA-1	B
GGCAAAGGCGCCAATA-1	A
GGCAAATTACTTTACT-1	E
GGCAAGCCAGGGATAG-1	C
GGCAAGGCGAAATAGC-1	E
GGCAATAGTCAATGAG-1	F
GGCACTCCACTGGGCA-1	F
GGCAGCGGTAATCCTA-1	C
GGCATACAGGTAGCGG-1	D
GGCATATCGGTTCTGC-1	H
GGCCCAATCTAGAGGG-1	C
GGCCCAGTTATCAGCA-1	C
GGCCCGGAGCATGTCT-1	G
GGCCCGTATACCATGC-1	I
GGCCCTCACCCACTTA-1	E
GGCGAAATCTAACTTG-1	B
GGCGAACCGTTCTGAT-1	C
GGCGCAGGACATCTTC-1	D
GGCGCATGAATTGATG-1	E
GGCGCGTTCGAGTTTA-1	E
GGCGGAGTAATATTAG-1	A
GGCGGTAGGATCATTG-1	F
GGCGTCCTATCCGCTG-1	D
GGCTAAAGGGCGGGTC-1	H
GGCTAATGATTGAAAT-1	C
GGCTATTAAGTTGTAT-1	A
GGCTCCTCCACCTGTT-1	D
GGCTCGCGTTGAGGTA-1	B
GGCTCGTGCCACCAGC-1	D
GGCTCTGCTCCAACGC-1	F
GGCTGAGCATCGTAAG-1	C
GGGAACGGGAGGTTAG-1	A
GGGAATGAGCCCTCAC-1	C
GGGACTGCATAGATAG-1	F
GGGAGAACTCACAGTA-1	F
GGGAGGATGCCCGAAA-1	E
GGGAGTTAATGAGGCG-1	B
GGGATCCCAATACAAA-1	C
GGGATGGTCGTAACCG-1	E
GGGATTTACCGCACCT-1	B
GGGCCCGTCTTAAACA-1	E
GGGCCGGCCGAAGTAC-1	B
GGGCCTATTTAAGTAT-1	C
GGGCGATATGTGTGAA-1	F
GGGCGCAGCGTTACTC-1	E
GGGCGGCAAATGAATT-1	E
GGGCGGGTTCCCTACG-1	A
GGGCGTACATTTATAT-1	A
GGGCGTCACCACGTAA-1	E
GGGCGTCCACTGGCTC-1	H
GGGCTCATCGAACCCA-1	F
GGGCTGCCTAGGGCGA-1	B
GGGCTGGTTAGTCGCG-1	F
GGGTACTTCATGAACT-1	A
GGGTATGTATGCACTT-1	D
GGGTCACCGTGACGGT-1	F
GGGTCGTGGCAAGTGT-1	I
GGGTGACACCTTAACT-1	E
GGGTGCATATGAAAGC-1	F
GGGTGGTCCAGCCTGT-1	D
GGGTGTTTCAGCTATG-1	A
GGGTTAACATTTGAGT-1	A
GGGTTTAGGATAGGAT-1	G
GGTAAATGTGCGTTAC-1	A
GGTACAAACATGCTAT-1	E
GGTACACCAGATTTAT-1	I
GGTACCATTAAGACGG-1	F
GGTAGACCGTTGGGCG-1	F
GGTAGTGCTCGCACCA-1	B
GGTATAGTGACACATA-1	F
GGTATTGCCGAGTTTA-1	E
GGTCAGTGGGTCCCAC-1	E
GGTCATTGTAGTCATA-1	C
GGTCGGATAAACGGCG-1	H
GGTCGGCCAGGAGCTT-1	B
GGTCGGTCGTCCACAG-1	A
GGTCTCTGAATGGACT-1	A
GGTCTGAGAATCTGGA-1	B
GGTGAAGTACAGGGAT-1	A
GGTGATAAGGAGCAGT-1	B
GGTGCAGAGCCTATCG-1	C
GGTGCGGATAAGTGGC-1	D
GGTGCTGGTACACATT-1	E
GGTGGACCACGTGTTA-1	C
GGTGGAGGTTGATACG-1	G
GGTGTTCTGTTTCTAC-1	C
GGTTACCACCCTCGGG-1	A
GGTTACCCGACACTTT-1	E
GGTTAGCTATATGTCT-1	B
GGTTAGGCTTGGAGAA-1	D
GGTTCCCTAGTGTCTC-1	C
GGTTCTACTCGTCTGA-1	G
GGTTTAATTGAGCAGG-1	I
GGTTTACAATCTCAAT-1	F
GGTTTAGCCTTTCTTG-1	B
GGTTTCAATCGGTCAG-1	B
GGTTTGACAAGAAGCT-1	C
GGTTTGCGAACACGTA-1	C
GTAACAACTGACCTTG-1	C
GTAAGCGGGCAGTCAG-1	H
GTAAGGATTTGTCGGA-1	A
GTAAGTAACAGTCTGG-1	B
GTAAGTAGGGTATACC-1	D
GTAAGTCCACACTCTA-1	G
GTAATAAAGGGCTCCC-1	F
GTAATCTGATTCTTCG-1	F
GTACACTTACCTGAAG-1	B
GTACAGAGGCAAGGGT-1	B
GTACGAGATTGCGACA-1	A
GTACGCTTCATTGCAC-1	G
GTACGTCACGTATTAA-1	C
GTACGTTTGCCCGTCA-1	E
GTACTAAGATTTGGAG-1	F
GTACTCCCTTATCGCT-1	D
GTACTCCTGGGTATGC-1	F
GTACTGGAGTTAGACC-1	B
GTAGAGGGAGACAAGT-1	A
GTAGCGGCTATACACT-1	B
GTAGCTTCCTCTTGTT-1	B
GTAGGTGATCCGTGTA-1	H
GTATAGGACTCAGTAG-1	A
GTATAGTGGCCCATGT-1	E
GTATCAGCTTGGGTTC-1	E
GTATCTTTCATAACCA-1	E
GTATGTGGGTCTAGTT-1	B
GTATTAGGGTTCGCGT-1	C
GTATTCTGAGAAACGA-1	A
GTCAAGCGGACTCGGG-1	B
GTCAATGCTATAATTT-1	C
GTCACAAAGTTTCCAA-1	D
GTCACTCTCCAAATCT-1	D
GTCAGAATAGTCTATG-1	D
GTCAGTTGTGCTCGTT-1	D
GTCATGCACCTCCGTT-1	F
GTCATGGACATGACTA-1	H
GTCATTAGAGCGAACG-1	B
GTCCATTACTGCTACG-1	G
GTCCCAACGTAAAGTA-1	B
GTCCGGCTGAATTGCG-1	E
GTCCTTCTAGTGGGTT-1	C
GTCCTTTAATGACTTC-1	C
GTCGCCGTTGTGTGTT-1	A
GTCGCGTAACCCGTTG-1	B
GTCGGAAGGATACCAG-1	C
GTCGGATATCTCAGAC-1	A
GTCGGATGTAGCGCGC-1	H
GTCGTACCATCTCGGG-1	E
GTCGTATTGGCGTACA-1	H
GTCGTCTGGTTGGCTA-1	I
GTCGTGTCTGGTCATC-1	F
GTCGTTATTCGCTTAT-1	B
GTCTATCTGAGTTTCT-1	F
GTCTCGACTAAGTTTG-1	I
GTCTCGATCTGCTTTC-1	H
GTCTGGGCGGTCGAGA-1	E
GTCTTAGTACAGCCGG-1	A
GTCTTGAGGAGCAGTG-1	G
GTCTTGTAGCTATTCA-1	G
GTGAAACGGCGCCACC-1	F
GTGAACTCCCATTCGA-1	F
GTGAAGATTTCAAGTG-1	I
GTGAAGCCGTATAGTC-1	I
GTGACCGCACACTACG-1	B
GTGACCTAAAGAATAA-1	I
GTGACGAGGGTGACCC-1	F
GTGACTTCAGTAGTGC-1	E
GTGAGCGTGCTGCACT-1	D
GTGAGGACACTTAAGG-1	B
GTGAGGAGCGGTTGAG-1	C
GTGAGTGGTACAACGC-1	E
GTGATCACTAACGCCT-1	B
GTGATCATAGATCTGC-1	E
GTGATGCACAACATCT-1	C
GTGATTCGCCGCTCAA-1	A
GTGCAACAAATGTGGC-1	A
GTGCACGAAAGTGACT-1	A
GTGCCATCACACGGTG-1	A
GTGCCCGTTCGGATTC-1	B
GTGCCGCTTCAAAGGT-1	E
GTGCCTCAGTGTACGG-1	C
GTGCGAAATCGAACAC-1	E
GTGCGACAGGGAGTGT-1	B
GTGCGGGTCTCCAAAT-1	A
GTGCGTGTATATGAGC-1	B
GTGCTCAAGTACTGTC-1	E
GTGCTTACATCAGCGC-1	G
GTGGAACCTACATGCG-1	H
GTGGACCAACCCGATT-1	D
GTGGACGTGCTGAGAC-1	D
GTGGAGCATGTCGGCC-1	G
GTGGAGTCGGCGGTTG-1	A
GTGGGCTTAGACACAC-1	E
GTGGTATAGTCTGCCG-1	A
GTGGTCAGCGAAGTAT-1	C
GTGGTGGCCAAGTGAA-1	B
GTGGTTACTTCTTTCG-1	F
GTGGTTTCCGCCTTTC-1	A
GTGTACCTTGGCTACG-1	F
GTGTACGAACCGTTCC-1	G
GTGTCCGATAAGGCAT-1	E
GTGTCGTATTCACCTT-1	C
GTGTGAATAACTTAGG-1	B
GTGTTACTATGCGTCC-1	B
GTTAACTATGTTGTCA-1	G
GTTAAGTTAGAGTGGG-1	G
GTTACAATTGGTGACG-1	A
GTTACCTACAACTTGC-1	E
GTTACTTTGGGCCTAG-1	E
GTTAGAGTGTGCCGCT-1	D
GTTAGCCGTAAATCAA-1	F
GTTATATCAGGAGCCA-1	I
GTTATATTATCTCCCT-1	E
GTTATTAAATACGACC-1	E
GTTCAATCTATGTCAA-1	C
GTTCACAGGAGTCTAG-1	D
GTTCATCGTTTGGCTG-1	F
GTTCCAGTCTGACCAT-1	A
GTTCGCCATAAGTGCC-1	E
GTTCGGATCGGGAACA-1	G
GTTCGGGCGTACCATT-1	F
GTTCGTCTGGGTCCCT-1	C
GTTCTTCCCTCGATGT-1	D
GTTGAACCGGTTCCAT-1	A
GTTGCACGGAGTTTCG-1	A
GTTGCGCTAACATTAC-1	G
GTTGGACCGCATCAGG-1	C
GTTGGATTCAGTGGCT-1	C
GTTGGATTGAGAACAC-1	B
GTTGGATTTGCGTTGG-1	E
GTTGTCGTGTTAGTTG-1	D
GTTGTTACATTGCGCT-1	C
GTTTACGTTCCATCTG-1	E
GTTTCATATCGTCGCT-1	D
GTTTCCTGGAGGGTGA-1	A
GTTTCTGCAGTCTCCC-1	B
GTTTGACCAAATCCTA-1	F
GTTTGGCCCAAGTTAT-1	B
TAAACCCAGGAGGGCA-1	A
TAAAGACAACCCTTTA-1	G
TAAAGCGTTAGGAGAA-1	G
TAAAGCTGCAATAGGG-1	H
TAAATCTTTACACCTC-1	I
TAAATGCCGTCTCATG-1	C
TAACAAAGGGAGAAGC-1	D
TAACATACAATGTGGG-1	B
TAACCTACCGTCCGAG-1	F
TAACGCTTTGAGAGCG-1	D
TAACTATCGAAGGTCC-1	D
TAACTATTACGCCAAA-1	F
TAACTCATCCGCGCGG-1	E
TAAGCCCTTACGACCA-1	C
TAAGGAACTTGTGGGA-1	D
TAAGGCAACATAAGAT-1	F
TAAGGCATAACATCAA-1	A
TAAGGCTGAATCCCTC-1	B
TAAGTAAATGTGCCGC-1	C
TAAGTAACATCTTGAC-1	A
TAAGTCGCCGAGTATC-1	A
TAATAAACAAGGAGAT-1	H
TAATACACAGTAGTAT-1	A
TAATAGAACAGAGTTA-1	A
TAATAGCTAAATGATG-1	I
TAATAGTGACGACCAG-1	G
TAATATTGAAATTCGC-1	D
TAATCGATCCGTACGT-1	F
TAATTAGGACATCCGT-1	G
TAATTGGAATCGGGAA-1	C
TACAACGCACAACTCA-1	E
TACAAGTCTCGTGCAT-1	D
TACACCGTCGTTAGTC-1	I
TACATAGGCATACACC-1	E
TACATTTCTAACGTGC-1	E
TACCAGAAGTAGGTTC-1	E
TACCAGCTAGGTTTAA-1	D
TACCGCGGACTTGCAG-1	B
TACCGGCTCACTGCCC-1	E
TACCGGTCGTTTCCAT-1	A
TACCTCACGCTTGTAC-1	A
TACCTTAAGATTTCCC-1	D
TACGAACACGACTTCA-1	F
TACGACGCTTGCTGCG-1	E
TACGACTGCCTCTTAG-1	E
TACGAGAACTTCACGT-1	A
TACGATGTTGATCATC-1	A
TACGCAGTTCTTTCCT-1	E
TACGCCATATTCTAAT-1	E
TACGCCGAGGGTACCC-1	A
TACGCTATAGAAACCT-1	F
TACGGGATGCTAGCAG-1	H
TACGTGCAAGGTTCCT-1	E
TACGTGCACTATGCTG-1	D
TACGTTTACCGGCAAT-1	A
TACTATGGTTCCTCAG-1	A
TACTCTCCGAACAAAT-1	H
TACTCTTTCGTCTTCA-1	D
TACTGAACAGATTTAG-1	A
TACTGCAATCAATTAC-1	I
TACTGGACAGCTCGGC-1	D
TACTTGTTAGTAGTCC-1	B
TACTTTACTGAGCCGG-1	F
TAGAAACCACTAAGTA-1	D
TAGAAAGGTGGCGCTA-1	B
TAGAATTAAGGGCAAC-1	A
TAGACGCCCGTACCGG-1	B
TAGACTACCTAGCGTT-1	F
TAGAGATCATGCAACT-1	D
TAGAGCTACGAAGAAC-1	D
TAGAGTCTAAGCGAAC-1	F
TAGATATGGACTGGAA-1	E
TAGATCCGAAGTCGCA-1	A
TAGCCATTTCAAAGTC-1	B
TAGCCGGCGGTCAGCG-1	B
TAGCGTCCCTCGATTG-1	G
TAGCGTTGGGTCTTAC-1	B
TAGCTAAGTCCGGGAG-1	F
TAGCTAGAAGGCATGA-1	E
TAGCTCAGATCCTAGT-1	C
TAGCTCGCCTGATAAC-1	E
TAGGAACAGCCTCCAG-1	C
TAGGCATGTTACGCCA-1	F
TAGGGAGCTTGGGATG-1	B
TAGGGTGTTTCAAGAG-1	A
TAGGTCGCCGGAACTG-1	G
TAGGTGAGCCCTACTC-1	D
TAGGTGCTCGCCTAGC-1	B
TAGGTTCGAGTTCGTC-1	B
TAGTCCGCAGAGAATG-1	E
TAGTCGATCACGGGTT-1	B
TAGTCTAACAACGAGA-1	A
TAGTCTGTGACGTTGC-1	I
TAGTGCCCTCCAGAGT-1	F
TAGTGGAACTCATACA-1	D
TAGTTAAGATAGGATA-1	C
TAGTTTATTCTTGCTT-1	D
TATAAATCCACAAGCT-1	D
TATAAGTGAGGATAGC-1	D
TATACACAGACGCCTT-1	E
TATACACGCAAAGTAT-1	E
TATAGATGGTCGCAGT-1	B
TATATCCCTGGGAGGA-1	B
TATATTACAAATGTCG-1	C
TATATTCGCGTCGATA-1	D
TATCACCATGTAAAGT-1	C
TATCACCCAACCGACC-1	G
TATCACTTCGAGTAAC-1	H
TATCCATATCATGCGA-1	A
TATCCTGCATGGGAAT-1	D
TATCGATCTATGCATA-1	F
TATCGATGATTAAACG-1	A
TATCTACCACAGCGGG-1	E
TATGATAAATCTAACG-1	D
TATGATCCGGCACGCC-1	I
TATGCTCCCTACTTAC-1	H
TATGGATGTGCTACGC-1	E
TATGGCCCGGCCTCGC-1	D
TATGGCTAGGCTAATT-1	I
TATGGGACCGAGCAGG-1	E
TATGGGTACGTATCGT-1	F
TATGGTCTGAGTAACA-1	E
TATGGTTAGTGGGAGA-1	F
TATGTCAAGACCGACT-1	H
TATGTCTCATTGTGCC-1	B
TATTAACCTGACCGCG-1	A
TATTACCATCCTGCTT-1	B
TATTCAATTCTAATCC-1	B
TATTCCACTCAGCTCG-1	E
TATTCCTCCGCCCACT-1	A
TATTCGTGCCAGAATA-1	B
TATTGACATTTCTGCC-1	G
TATTTAGTCTAGATCG-1	A
TATTTATACCGAGTAG-1	H
TATTTGTTACCCTTTA-1	A
TCAAACAACCGCGTCG-1	H
TCAAACTTAGATTGTT-1	F
TCAACAAAGATAATTC-1	D
TCAACATAGCGCCCTA-1	A
TCAACCATGTTCGGGC-1	A
TCAACGAGGAGACAAA-1	E
TCAACGCAGGAAATAA-1	A
TCAACGCGACCGGCAG-1	D
TCAAGAAATACTAGCT-1	F
TCAAGCTGCCTTGAAA-1	I
TCAAGGTTACTACACC-1	B
TCACAGCAAACTCGAA-1	F
TCACAGGAGAATAAGA-1	A
TCACAGGGAATCGCAA-1	B
TCACAGGTTATTGGGC-1	F
TCACCCTCTTAAGATT-1	E
TCACCGCTCGGCACTC-1	B
TCACGATGTCCGTGGA-1	D
TCACGCATTGTAGATC-1	F
TCACGGTCATCGCACA-1	A
TCACGTGCCCGATTCA-1	E
TCACTACGACCAATGC-1	C
TCACTCGTGCAACGGC-1	H
TCAGAACCTCCACAGG-1	F
TCAGACGCTATAGAAG-1	G
TCAGATGGAGACGTAG-1	C
TCAGCAAATGCATCTC-1	B
TCAGGGTGCACGAAAC-1	C
TCAGGGTGTAACGTAA-1	F
TCAGGTTCTTTGAGAA-1	A
TCAGTACTGACCCGCG-1	D
TCAGTAGGGACTATAA-1	E
TCAGTGTATACGTCAT-1	D
TCATCCCAGAGGGTGG-1	A
TCATCGATGGTCCCAA-1	D
TCATGCAGGTTCTCAT-1	H
TCATTCGTATAATTTG-1	C
TCATTTAAGTCTCCGA-1	B
TCCAACTTTAAATTCT-1	A
TCCACAATGGTTTACG-1	D
TCCACTTTATCTAGGT-1	B
TCCAGAGCACCGGTTC-1	B
TCCAGATGTACGCCAA-1	I
TCCAGGCGAGTACGGT-1	F
TCCATTCCCACTAGAG-1	C
TCCATTGTGACCTCGT-1	A
TCCCAAACAGACAACG-1	I
TCCCAAAGACGAAGGA-1	H
TCCCAAAGCCCTAAAT-1	G
TCCCACTCTCTTCCGG-1	F
TCCCAGCTTTAGTCTG-1	E
TCCCAGGCTTAGCTAA-1	A
TCCCGCCTATGTGCGT-1	E
TCCCGCGTACTCCTGG-1	F
TCCCGGGTGTGCTGCT-1	D
TCCCGTCAGTCCCGCA-1	F
TCCCGTCGCGTCATAG-1	I
TCCCGTGTGCAATTTG-1	B
TCCCTAGATCAATAGG-1	I
TCCCTGGCTCGCTGGA-1	D
TCCCTTAGATTACTCG-1	H
TCCGAAGTAGTCACCA-1	C
TCCGAATGGTCCTGAG-1	F
TCCGATAATTGCCATA-1	A
TCCGATGACTGAGCTC-1	H
TCCGATGGTGCGACAT-1	A
TCCGATTACATTGCCG-1	D
TCCGCGGCAGCATCTG-1	B
TCCGCTGTCATCCCGG-1	B
TCCGCTTATCCCATTA-1	E
TCCGGAGGAAGGGCTG-1	C
TCCGGCCTAGCGTACA-1	F
TCCGGTTCGTCCGGTC-1	E
TCCGTTTAGCCTTGAA-1	B
TCCTACATCCACGGCC-1	B
TCCTAGCAAAGAAGCT-1	A
TCCTCGGGCTGGGCTT-1	B
TCCTCTACGAGATGGC-1	D
TCCTCTGGCCCATTAG-1	C
TCCTGCCAACTGGAGA-1	C
TCCTGCGTTGATACTC-1	D
TCCTGGCGCTGCCTGG-1	C
TCCTTCAGTGGTCGAA-1	A
TCCTTTCTTACGCTTA-1	F
TCGAAATTTAGGACCA-1	A
TCGAAGAACCGAGCAC-1	B
TCGAATATCCCGCAGG-1	D
TCGAGACCAACACCGT-1	E
TCGAGCCAGGCAGGCC-1	A
TCGCAAAGATGCATTT-1	G
TCGCCCAACTGACTCC-1	C
TCGCCGAAGTTGCGTC-1	A
TCGCCGGTCGATCCGT-1	A
TCGCGTCCAGAAGGTC-1	D
TCGCTAAACCGCTATC-1	H
TCGCTCGATATATTCC-1	F
TCGCTCGGCACCAGCG-1	I
TCGCTGGGCGGATTGT-1	F
TCGCTGTGCGTAAATC-1	D
TCGCTTAATTACGAAG-1	C
TCGCTTTAAACGTTTG-1	F
TCGGAATGACCATCAA-1	D
TCGGAATGCGCTCTGA-1	D
TCGGACGCCCAGCCCA-1	B
TCGGAGAGTATCGGGA-1	D
TCGGAGTACATGAGTA-1	B
TCGGCTAACTTCCCTT-1	E
TCGGGAACGTGCCTAG-1	F
TCGGGCCGTCGTGGTA-1	B
TCGGGTGAAACTGCTA-1	D
TCGGTCCCTGACTCCA-1	C
TCGGTGACCGCTCCGG-1	C
TCGGTTAGCCATGTAG-1	C
TCGTAAGACGACATTG-1	F
TCGTAAGCTCCGAGGA-1	C
TCGTATAGTGCAATTA-1	D
TCGTATTACCCATTGC-1	D
TCGTATTTCGTCCGGA-1	D
TCGTCAAGTACGCGCA-1	A
TCGTCCGCTGGCGTCT-1	D
TCGTCCGGGTACACTC-1	C
TCGTGTACTATGGATG-1	F
TCGTGTCACGCTGACA-1	D
TCGTTAGGAGTCCCTA-1	F
TCGTTCGTTATTATGT-1	D
TCGTTGCTATCCGGTC-1	A
TCTACACGTTCATGCA-1	C
TCTACCGTCCACAAGC-1	F
TCTACGGGCTCAGTTG-1	C
TCTAGCAATCTCCGCC-1	A
TCTAGCATCTTCGATG-1	D
TCTAGCATGCCCAGAA-1	F
TCTAGGTGGCGACGCT-1	F
TCTAGTGATATCGTGG-1	B
TCTAGTTATCAGAAGA-1	E
TCTATCATGCAGTTAC-1	D
TCTATCGGTCGCAACA-1	H
TCTCCAACGTAGGTTA-1	H
TCTCGAACGAGGTCAC-1	C
TCTCGACGTATCGCCG-1	G
TCTCTAATAGCTGGTA-1	A
TCTGAACCGGTCGGCT-1	D
TCTGAACTCGTACCCG-1	B
TCTGAATTCCGTACAA-1	B
TCTGACGGGCTAACCC-1	I
TCTGATCGGGTGCTAG-1	F
TCTGATTGGAAATGGA-1	G
TCTGCACCATTAGTAA-1	I
TCTGCCAGAAACTGCA-1	B
TCTGCGAATCGTTCGC-1	C
TCTGGAGCGTAAGAGT-1	G
TCTGGCCGTTCAAGTT-1	G
TCTGGGAACCTTTGAA-1	B
TCTGGGTAGCGCTCAT-1	A
TCTGTGATGGAGGTTG-1	C
TCTGTGCCATCATAGT-1	B
TCTGTTACCCAGCATA-1	A
TCTTACAGAGGTACCG-1	D
TCTTACCGGAACTCGT-1	F
TCTTACGGCATCCGAC-1	D
TCTTACTTATGCCTCT-1	B
TCTTAGAGCTCCAATT-1	G
TCTTAGAGTGAACTCT-1	B
TCTTCCCATGGGCACA-1	B
TCTTCGAATAGACGTT-1	B
TCTTCGATACCAATAA-1	F
TCTTCTATAACCCGCC-1	G
TCTTGATGCGTAGCGA-1	F
TCTTGGTAACACCAAA-1	H
TCTTTAAGACTATGAA-1	F
TCTTTAGCAGGCGAAC-1	F
TCTTTCTCTTAAGGAG-1	D
TGAAACTTATGCAAGC-1	A
TGAAAGGACCTGACTC-1	B
TGAATATGCTATAAAC-1	C
TGAATGAGATACAGCA-1	C
TGACAACGCATGTCGC-1	G
TGACACTTCTCTTTGC-1	C
TGACATCGAGCGGACC-1	G
TGACCAGCTTCAAAGT-1	C
TGACCCACGTTAGACA-1	F
TGACGAATATTTCCCT-1	E
TGACGATGCACTAGAA-1	B
TGACTATAATCCTTTC-1	E
TGAGAATGCTTTACCG-1	A
TGAGAGATTTACCACG-1	B
TGAGATCAAATACTCA-1	D
TGAGATTAGGCCCTAA-1	H
TGAGCCATACAGTCTC-1	A
TGAGCTTTAATGACGC-1	H
TGAGTAAATTAGCGTA-1	E
TGAGTGCCTCTTAAAT-1	F
TGAGTGGTCCGTGACG-1	B
TGATACATTTAGCCGT-1	A
TGATCAGGGAACTGCT-1	D
TGATCCCAGCATTAGT-1	G
TGATCGGTTTGACCCT-1	F
TGATCTACGCTGATCT-1	C
TGATCTCCGGCGCCAG-1	A
TGATGGCTGTTTCTGA-1	G
TGATTATGGCACGCAG-1	C
TGATTCGTCTATCACT-1	A
TGATTCTGTCGCCGGT-1	E
TGATTTATTAGCTGTG-1	A
TGCAAGAATGACGTAA-1	F
TGCAATTTGGGCACGG-1	C
TGCACAGTGAAGTTAT-1	C
TGCACGAGTCGGCAGC-1	D
TGCAGAACTATATCGT-1	E
TGCAGAGTACCGAGCA-1	E
TGCAGGATCGGCAAAG-1	F
TGCAGTGAGGCTCGGG-1	C
TGCAGTTTCCTCCCAT-1	B
TGCATATGTCTGTCAC-1	B
TGCATGGATCGGATCT-1	H
TGCATGTGGTAATCTA-1	B
TGCCAATGGGTACTCT-1	A
TGCCACCTGGCGAAAC-1	H
TGCCATGGCTTATAAG-1	E
TGCCATTACTAAAGAA-1	F
TGCCCGTACCGTTAAA-1	B
TGCCGAAAGCGTATTC-1	E
TGCCTAAATTTAATAG-1	G
TGCCTGATCAAACGAT-1	H
TGCGACACCCTAGTGC-1	E
TGCGAGAATATTACCC-1	A
TGCGAGATGGCGGCCA-1	C
TGCGAGCCCTTCCGCG-1	C
TGCGCAAAGCATTTGG-1	F
TGCGCCGTTAATAACG-1	G
TGCGCGATTAACGGAG-1	A
TGCGGAGTAAAGGTGC-1	H
TGCGGCATAGTTCAAC-1	D
TGCGGTGAAATTTCAT-1	A
TGCGTAAGAACCTGAT-1	E
TGCGTTTGTTGACACT-1	B
TGCTCCACAGTTCTTA-1	B
TGCTCTGCCGGTTCAC-1	I
TGCTGCGTCAGAGTTA-1	C
TGCTGGTTGGACAATT-1	D
TGCTGTTGAAGAACTC-1	B
TGGAACCACTGACACA-1	I
TGGAAGAAGGGAACGT-1	A
TGGAAGACGAACACCA-1	D
TGGAAGGATAAAGATG-1	H
TGGAATATCCTTGACC-1	I
TGGACTGTTCGCTCAA-1	B
TGGAGCTAAAGTTCCC-1	D
TGGAGGGAAACACCTC-1	I
TGGAGTGATGCGATGA-1	A
TGGCAACTCGCGCGCC-1	F
TGGCACGAGCTCGAGT-1	C
TGGCAGATTACGATCA-1	E
TGGCAGCAGTAATAGT-1	E
TGGCCAAACTGAAGTA-1	F
TGGCCGTATATTGACC-1	D
TGGCGACTGCTCCAAA-1	A
TGGCGATCAAGTTATG-1	E
TGGCTTGTACAAGCTT-1	C
TGGCTTTGGGTAGACA-1	A
TGGGATGCACTCATTC-1	C
TGGGCAATAGTTGGGT-1	F
TGGGCACGTTCTATGG-1	A
TGGGCCACAAGAGCGC-1	H
TGGGCCCATACTAATT-1	B
TGGGTAAGGTTCCCGC-1	C
TGGGTGGGATGTCATT-1	C
TGGTAGAATATATGGG-1	B
TGGTATCGCATCCCAA-1	D
TGGTATCGGTCTGTAT-1	D
TGGTCTGTTGGGCGTA-1	D
TGGTTAAGGGCGCTGG-1	I
TGGTTCGTAGCAAAGG-1	A
TGGTTGGAGGATCCTG-1	C
TGGTTTAAACGTGGGT-1	I
TGTACGAACAAATCCG-1	E
TGTACTACTCTCACGG-1	C
TGTAGGAGAAATTTCC-1	B
TGTAGTGATCTATAAT-1	D
TGTATAACAGATCCTG-1	B
TGTATACGGATGATGA-1	I
TGTATCAGACTGAAGC-1	C
TGTATCCTTATTCCAT-1	E
TGTATGGCGCAGACAG-1	B
TGTATTTACCTAATGC-1	C
TGTCATTTGTTGGGAA-1	I
TGTCCCGACATAGCAC-1	D
TGTCCTAAGTCACCGC-1	D
TGTCTACAGTTTCTGT-1	D
TGTGACTACGCCAGTC-1	H
TGTGGCAAAGCGTATG-1	B
TGTGGCTCCCACCAAC-1	G
TGTGTCGCGAGTTGCA-1	D
TGTTATTGTATGTGGC-1	B
TGTTCCGCTTCCATGA-1	E
TGTTCGTATTGCGGTG-1	E
TGTTCTCTACTCCCTA-1	C
TGTTCTTCCATTGACT-1	A
TGTTGTCAAGAAGTCT-1	F
TGTTTAATACTTCATC-1	A
TGTTTCGGTACTTCTC-1	A
TTAAACTCGAATTCAT-1	F
TTAACCAACCCTCCCT-1	A
TTAACGAACAAGCAGT-1	I
TTAACGTCGCAAGACC-1	D
TTAACTTCAGGTAGGA-1	D
TTAAGACGAACGAACC-1	C
TTAAGATAGGATTGAC-1	B
TTAAGCCGACAACTTC-1	A
TTAAGCGCCTGACCCA-1	A
TTAATCAGTACGTCAG-1	H
TTAATGCGAGGTAACT-1	E
TTAATGTAGACCAGGT-1	F
TTAATTTCAGACGCGG-1	A
TTACAACTACGCATCC-1	A
TTACAGACCTAAATGA-1	F
TTACATCGTGGCCTGG-1	D
TTACATGCCACAACTA-1	B
TTACCATTGATTACCC-1	D
TTACCCATTGCCGGGT-1	H
TTACGGATGGTTCGAG-1	B
TTACTAAAGGACTTTA-1	B
TTACTCCGGCCGGGAA-1	B
TTACTCTGGTACGTAC-1	A
TTACTGGGATATTTCA-1	E
TTACTGTCTAGAGCTC-1	C
TTAGACACGATCGTTG-1	H
TTAGACGAGTCACCTC-1	B
TTAGAGTTTAGAAGGA-1	B
TTAGCTAATACGATCT-1	H
TTAGCTGATTTGCCGT-1	B
TTAGGTCATAACCGAC-1	A
TTAGTAGGGCGGCGGG-1	D
TTAGTTATTCGTGGCA-1	B
TTAGTTCAAGTGTTCG-1	I
TTATAGTCCAAGGTGC-1	C
TTATATACGCTGTCAC-1	B
TTATATTTGGCAATCC-1	H
TTATCTGTATCATAAC-1	A
TTATGAATGAAAGGGA-1	E
TTATGACAAACTGGAT-1	D
TTATGATCTTAACGAA-1	B
TTATTAGAGCGTGTTC-1	G
TTATTAGGGAAGCATC-1	A
TTCAAAGTCTCTAGCC-1	B
TTCAACGACCCGACCG-1	A
TTCAAGCCGAGCTGAG-1	A
TTCAATACTCTGAATC-1	B
TTCAATTAGCCATAAT-1	A
TTCACGAAAGGATCAC-1	E
TTCAGCCCTGGTCCAC-1	B
TTCATGGCGCAACAGG-1	H
TTCCAATCAGAGCTAG-1	F
TTCCAATCTGGCTATC-1	E
TTCCACACAGATTTGA-1	F
TTCCAGACGAGATTTA-1	G
TTCCATCATGCGGTGA-1	C
TTCCGCAGAGAAATAT-1	I
TTCCGCGTGAGGCGAT-1	E
TTCCGGCCTTGAGGCT-1	A
TTCCGGCTCGACTTCT-1	C
TTCCGGTATCTGTGTC-1	G
TTCCGGTTACCCACTT-1	B
TTCCTCGAGGGTGTCT-1	A
TTCGACGGGAAGGGCG-1	A
TTCGAGCCGGCGCTAC-1	C
TTCGCACTCGCGTGCT-1	A
TTCGCTAGGAAGTTGT-1	G
TTCGCTATCTGACGTG-1	H
TTCGGACTGATGCCTT-1	C
TTCGGCAACCCGCTGA-1	H
TTCGGGACTAATCGCG-1	B
TTCGGGCGCTAGTCTT-1	A
TTCGTAATCCCAGCGG-1	C
TTCGTACTCCAGAACG-1	D
TTCGTTCAACGAAGTT-1	I
TTCTAACCGAAGCTTA-1	B
TTCTACCTTTATGTTG-1	D
TTCTACTTGCGAGGGC-1	D
TTCTAGGCCAATTGTG-1	D
TTCTATGCCTTTCGCA-1	I
TTCTGCCGCGCCTAGA-1	G
TTCTGCGGGTTAGCGG-1	B
TTCTGCTAGACTCCAA-1	F
TTCTTAGTGAACGGTG-1	E
TTCTTAGTGGCTCAGA-1	A
TTCTTGAGCCGCGCTA-1	A
TTCTTGCTAGCATCTC-1	G
TTCTTGGACGATCTGC-1	A
TTCTTGGAGTAATGAG-1	H
TTCTTGTAACCTAATG-1	D
TTCTTTGGTCGCGACG-1	I
TTGAAAGGTGTAAAGG-1	H
TTGAAGAATTCCCAGG-1	F
TTGAATATGGACTTTC-1	B
TTGAATTCACGTGAGG-1	B
TTGACAGGAGCTCCCG-1	B
TTGACATGAACGTGGA-1	A
TTGACCATGTTCTCCG-1	F
TTGACCGTGTTAATGA-1	A
TTGACGCTCCATGAGC-1	B
TTGACTACCATATGGT-1	F
TTGACTATTGTCCGGC-1	B
TTGAGAGTACTGCTAA-1	A
TTGAGCAGCCCACGGT-1	G
TTGAGCGCCACGTGAT-1	G
TTGAGGCATTTAACTC-1	C
TTGAGTCCCGCTGCTG-1	G
TTGATAGTCAATACAT-1	I
TTGATCTAACTTTGTC-1	A
TTGATGTGTAGTCCCG-1	F
TTGATTAGCTGTTTCT-1	A
TTGATTATGCAGATGA-1	D
TTGCACAATTCAGAAA-1	E
TTGCACGGAGCAGCAC-1	A
TTGCATGCTGATCACG-1	A
TTGCCAAGCAGAACCC-1	G
TTGCCCTGATCACGGG-1	A
TTGCCGGTGATCCCTC-1	C
TTGCGGCATCAGAAAG-1	A
TTGCGTCGGCCAACCG-1	A
TTGCGTGAACGCTTAG-1	C
TTGCTCCCATACCGGA-1	H
TTGCTGAAGGAACCAC-1	A
TTGCTGATCATGTTCG-1	E
TTGCTGGCCGGGCTTC-1	C
TTGGAAGAATACAGTC-1	E
TTGGACATGTGGCTTA-1	D
TTGGATATCGTCTACG-1	E
TTGGATCGACTTCTGG-1	D
TTGGATTGGGTACCAC-1	A
TTGGCCTAGAATTTCG-1	H
TTGGCGATCCGAATAT-1	G
TTGGCTCGCATGAGAC-1	D
TTGGGACACTGCCCGC-1	F
TTGGGCGGCGGTTGCC-1	B
TTGGGTTTATTCAGCG-1	C
TTGGTATGGCTTGTGT-1	E
TTGGTCACACTCGTAA-1	E
TTGGTTCGCTCAAAGG-1	G
TTGTAAGGACCTAAGT-1	A
TTGTAAGGCCAGTTGG-1	B
TTGTAATCCGTACTCG-1	E
TTGTATCACACAGAAT-1	A
TTGTCGTTCAGTTACC-1	A
TTGTGGCCCTGACAGT-1	A
TTGTGGTAGGAGGGAT-1	D
TTGTGGTATAGGTATG-1	I
TTGTGTTTCCCGAAAG-1	E
TTGTTAGCAAATTCGA-1	D
TTGTTCAGTGTGCTAC-1	H
TTGTTGTGTGTCAAGA-1	B
TTGTTTCACATCCAGG-1	A
TTGTTTCCATACAACT-1	D
